string	string
123/456	123/456	TODO
/123/456	/123/456	TODO
usr/lib/../bin/gcc	usr/bin/gcc	TODO
./../	..	TODO
../../local	../../local	TODO
./.././../local	../../local	TODO
/foo/../foo/./../	/	TODO
/	/	TODO
///	/	TODO
/.	/	TODO
/./	/	TODO
..	..	TODO
../	..	TODO
/GCxwlF	/GCxwlF	TODO
/laomWCV/	/laomWCV	TODO
/BmhAXRf/DzsRpMOCq	/BmhAXRf/DzsRpMOCq	TODO
/xGoueEW	/xGoueEW	TODO
/yjXFKG/	/yjXFKG	TODO
/LPyY	/LPyY	TODO
/iThjBHJf/	/iThjBHJf	TODO
/lreBzkEmeq	/lreBzkEmeq	TODO
/hbvSyJ/	/hbvSyJ	TODO
/aTEzWHGP/	/aTEzWHGP	TODO
/ZDrzKywYnw/FBjwCdm	/ZDrzKywYnw/FBjwCdm	TODO
/mfyl/tXFsQo/	/mfyl/tXFsQo	TODO
/xSUUWoEctP//IymsTG/	/xSUUWoEctP/IymsTG	TODO
/bsOkumuC/./zgSaZ/../../LHg/	/LHg	TODO
rXkau/../../..	../..	TODO
/WBSpCOLDU/TrdOh	/WBSpCOLDU/TrdOh	TODO
/UANoiEPpeG/Ndukg/	/UANoiEPpeG/Ndukg	TODO
/eXsf/iRpv/ilN	/eXsf/iRpv/ilN	TODO
/OwdU/Lyagi/nCcLgdMgEB/	/OwdU/Lyagi/nCcLgdMgEB	TODO
/KBiasFk/AJk/DPzTGLHB/PxNfOVYK/	/KBiasFk/AJk/DPzTGLHB/PxNfOVYK	TODO
/grLXlZxE/AAVjXmiFM/CEe/../Uwb/vVcck/	/grLXlZxE/AAVjXmiFM/Uwb/vVcck	TODO
/fJYt/ieBe/./jNBLYYeX/	/fJYt/ieBe/jNBLYYeX	TODO
/nmcOG/iNMdrzmRuo/../xoBlw	/nmcOG/xoBlw	TODO
/iBUrPkorz/RVJ/./.././lQiYPVevX	/iBUrPkorz/lQiYPVevX	TODO
/bKQXdd/xeWZ/Qdx/../../vurni/../../HcOnB/./lMBAZ/.	/HcOnB/lMBAZ	TODO
THppChSOdC/./cdjvZm///../KmqLTCl/../././../SZpnU/..//../QugVcLv/./nEunvEoyZq/./xdhFUTDP/././//.//jOb///././/..///	../QugVcLv/nEunvEoyZq/xdhFUTDP	TODO
.///../CJXauSqZAx	../CJXauSqZAx	TODO
/bMWZVDLUV/././	/bMWZVDLUV	TODO
/kJrYcRTnh//	/kJrYcRTnh	TODO
/BfkgclWQ///XvNbFozbJ///xXdPdX/LYtBB/rfaASC///	/BfkgclWQ/XvNbFozbJ/xXdPdX/LYtBB/rfaASC	TODO
/eQIGlgkZK/qaP/././//xSUMKRngf///vmEVPmNFL//	/eQIGlgkZK/qaP/xSUMKRngf/vmEVPmNFL	TODO
..//	..	TODO
///klikq/FZVoaTy//	/klikq/FZVoaTy	TODO
/TdhV/..///wCVy/aGK///Iyzq/TsdS///..//	/wCVy/aGK/Iyzq	TODO
/skCvBrHhC/UfDRdBN/QUn///pMeueWIW	/skCvBrHhC/UfDRdBN/QUn/pMeueWIW	TODO
/CaruAv/gDXfIuqFX/MUcUwt	/CaruAv/gDXfIuqFX/MUcUwt	TODO
/Lgf///TroxLQ/PvkjRk/.	/Lgf/TroxLQ/PvkjRk	TODO
///wPY/Vuo///bCBMrbRzt/FFXDi/	/wPY/Vuo/bCBMrbRzt/FFXDi	TODO
..//	..	TODO
/dUyvl/WNVecOQft///FGwPswEJ/BHjtdryn/CyeUbkltXm/TluT//	/dUyvl/WNVecOQft/FGwPswEJ/BHjtdryn/CyeUbkltXm/TluT	TODO
/./vAOFkYa/OtniatZ/GcxNOtu///../Dwhh////	/vAOFkYa/OtniatZ/Dwhh	TODO
/./eejcNNO/fzaPQqus/../FqG/INui/./uPuUJyM	/eejcNNO/FqG/INui/uPuUJyM	TODO
/uSCZk/NTQMqf/../../JMoyr/./UwQ/.//	/JMoyr/UwQ	TODO
/././//OGMmKR/aWzxpL/NiSUPQn/OoB/.//	/OGMmKR/aWzxpL/NiSUPQn/OoB	TODO
IdCdtRmtmn/.././nQbIPdMXp/../././..//	..	TODO
///	/	TODO
/ttAMoSR/iECkonDeyS/nbOdVQf/etl///./../../	/ttAMoSR/iECkonDeyS	TODO
///mqGhgbHe/..	/	TODO
///DxAoJbA/../qMd/vxoFx/mSWwvs/TJyTKt/../	/qMd/vxoFx/mSWwvs	TODO
/RMJ/eCFMzD/	/RMJ/eCFMzD	TODO
/HJSjey/.//	/HJSjey	TODO
/./oVXO/./mSy/../XgQFiS/../../.	/	TODO
/ElpJP	/ElpJP	TODO
/xUjLezmNV/./xTgqhbnpQi///./UqGe/pwrfQA///MKJzLY/Ovx//	/xUjLezmNV/xTgqhbnpQi/UqGe/pwrfQA/MKJzLY/Ovx	TODO
/Xjczt/VpwAwcaK/MqscTqXfx/.	/Xjczt/VpwAwcaK/MqscTqXfx	TODO
../gMxMfmvtJN/	../gMxMfmvtJN	TODO
.././XPstDWi/hMprEt///../.././../yZfh/	../../yZfh	TODO
.././KER/../TamBPj/..//	..	TODO
/./gsBYFT/../xLsObg/FiVZVcYqe///vDdDFUdPmK///nvPvUHDqZ	/xLsObg/FiVZVcYqe/vDdDFUdPmK/nvPvUHDqZ	TODO
/aKnWxsDXC/sakVaJEmiy/nQkMdm/CrbuOxpVB/././/	/aKnWxsDXC/sakVaJEmiy/nQkMdm/CrbuOxpVB	TODO
/VMCgzqTjAx/.///Micm/.//	/VMCgzqTjAx/Micm	TODO
.././///	..	TODO
/Gtkxsz/JFKQuuKK//	/Gtkxsz/JFKQuuKK	TODO
..///VVG/MYLMC/sLHSzcZo/././	../VVG/MYLMC/sLHSzcZo	TODO
wEYLJ/..///../../SCkzZo/Urfia/	../../SCkzZo/Urfia	TODO
/UQhuBbU/FSYfsLg/DuqdAql/./AdVA/ahlYZAMY/	/UQhuBbU/FSYfsLg/DuqdAql/AdVA/ahlYZAMY	TODO
MmrWKyhZY/.././../..///jraT/tpwTqFIEX	../../jraT/tpwTqFIEX	TODO
../////nkKc/../	..	TODO
/qeUfzQ/////KdrDXP/UVUGiG/CJdoWslT/XnvAhexjq/././YzNoFclCnd//	/qeUfzQ/KdrDXP/UVUGiG/CJdoWslT/XnvAhexjq/YzNoFclCnd	TODO
/KtQs/UHO/EaVWoW/GZmsXea/QYbsbxTD/CBnVHwM/./JzeHyPqiC/eDTfEUGJY/	/KtQs/UHO/EaVWoW/GZmsXea/QYbsbxTD/CBnVHwM/JzeHyPqiC/eDTfEUGJY	TODO
../qKt/./././aLSMUsvQM	../qKt/aLSMUsvQM	TODO
/./trYT/YngnF//	/trYT/YngnF	TODO
.///../OInFqItojy/lzaujQK/./ISuJtj/MNuWE	../OInFqItojy/lzaujQK/ISuJtj/MNuWE	TODO
/IUySFCaUNH/QYsSFMk/../HbdBmT/NFvMUXH/UFmFkv/jHYHYVkDG/	/IUySFCaUNH/HbdBmT/NFvMUXH/UFmFkv/jHYHYVkDG	TODO
///loogww/	/loogww	TODO
///cAbKqHUG/RxzAoVU/Kohq/sPvuoC///qmEHxv/IeEcJRMeW/USeRmHpfO/.	/cAbKqHUG/RxzAoVU/Kohq/sPvuoC/qmEHxv/IeEcJRMeW/USeRmHpfO	TODO
////	/	TODO
./../	..	TODO
../AlPL/rCVNNv/./sosass///bVWLCvL///./	../AlPL/rCVNNv/sosass/bVWLCvL	TODO
/.	/	TODO
///soeKeZYLN/rBWBrHr/iRyaG/lzzZl/././ILju///.//	/soeKeZYLN/rBWBrHr/iRyaG/lzzZl/ILju	TODO
///yQn/dyoG/azaoft//	/yQn/dyoG/azaoft	TODO
.././sCWTeKOJ/BoXPgZRWR/hSbISAroKg/../mZDie/./	../sCWTeKOJ/BoXPgZRWR/mZDie	TODO
..///Hvi/././././../	..	TODO
../../diQokjMogW/./AdkiGpyBDr/krlWh/rGQSyZow/eXfY/tjmIUWmI/dDhorLC///PEFzQOQzu/.//	../../diQokjMogW/AdkiGpyBDr/krlWh/rGQSyZow/eXfY/tjmIUWmI/dDhorLC/PEFzQOQzu	TODO
/WQjVcUXtlg/QyhTT/./htnb/wdROiEX/../wSmw/..///..///..//	/WQjVcUXtlg	TODO
../ziF/../eVomaHGtyn/DGDGPggI/..///SCNaHd///noQYUek/	../eVomaHGtyn/SCNaHd/noQYUek	TODO
/LWWyiTQ/CfLPz/./UmWEK/./././ctTem/RGWMIUkp/..///../GvAufCGf	/LWWyiTQ/CfLPz/UmWEK/GvAufCGf	TODO
///mCHEPPV/./ViHgvUrpWN/./MsZSd/./../NBRQc/////.///OZCQJ/HLTXCIDtNW/./////..///./bCbxNWUIML///..////	/mCHEPPV/ViHgvUrpWN/NBRQc/OZCQJ	TODO
/lLqddkGy/////DASLtIn/.///CYBJ/../..///.///zkcKG/CvOKnBAvUs///./RHntcOSCq///..///../..///../zkUKHXZiq///.///fRp/	/zkUKHXZiq/fRp	TODO
/ygXSpgWIpI/./huBOs/tNDDdf///ERIfH/zvJzmjV/VvusMovY/iaqNBIksBN///GTzoAX///pfYC/CSVVRN/iXZlIGYtS	/ygXSpgWIpI/huBOs/tNDDdf/ERIfH/zvJzmjV/VvusMovY/iaqNBIksBN/GTzoAX/pfYC/CSVVRN/iXZlIGYtS	TODO
///QnmSO/xWBajR/BTWEs///./../..///./HoPaSJA/../Ksq///./kZxUy/zSdCPLL/ozlZp/MYolp///skQVzFJHih	/QnmSO/Ksq/kZxUy/zSdCPLL/ozlZp/MYolp/skQVzFJHih	TODO
/zWgqPF/YfDOPhUnl/.././Cfd/Rxd/./../cYPPdSmnpC/../dhUqQWXj///bnNTNWCuE/../PDBLg/TmgYm/.././	/zWgqPF/Cfd/dhUqQWXj/PDBLg	TODO
/.///nWtnoKPBM/ScXlu/dlNNDiZruY/HlX/werRGYrj/rzLiAOhpL/wMGwW/mhdBOmt/../../aLCBbAay/./LHpzIty/../akYbuvh/////YRObpG/./	/nWtnoKPBM/ScXlu/dlNNDiZruY/HlX/werRGYrj/rzLiAOhpL/aLCBbAay/akYbuvh/YRObpG	TODO
/.///OMhFKG/./bJhNShekrA/uFBSNFUXqX/DOBF///../IMYNCrxgil/zxtzOiUXg/RHvx/ATRVoahq/EhgLnOocL/rAfrpiqS/kOOsHSP///FOsj///..///..///lqUUa//	/OMhFKG/bJhNShekrA/uFBSNFUXqX/IMYNCrxgil/zxtzOiUXg/RHvx/ATRVoahq/EhgLnOocL/rAfrpiqS/lqUUa	TODO
/BUtNIqVh///nDSzsg/xgsIYT/GvUxPEeCWg///VjpcS/LIAcMahUch///zLkrN/./././tiFYqPA//	/BUtNIqVh/nDSzsg/xgsIYT/GvUxPEeCWg/VjpcS/LIAcMahUch/zLkrN/tiFYqPA	TODO
qroupr///.///wcWb/oqVelTzhbF/../../.././.././	..	TODO
/./././iECZaGxHs/mUmKZcmw/unjPn/GNrEErS/../../oDs/age/QgWBgoJjz/.././DOhVLb/../XYMRXH/.././WbNdhgRCbl/AZgQsmA/HjyuOFaYWh///YQEw/fEkSmDTQ/	/iECZaGxHs/mUmKZcmw/oDs/age/WbNdhgRCbl/AZgQsmA/HjyuOFaYWh/YQEw/fEkSmDTQ	TODO
/BdNPYOB///VkH/vOTlzaXcB/./../GuWVNGVUiH/ZsXRpmwsyE/vuXzH/./..///gkr/UVdQl/LTf/LfUr/TGqiMiLa/../Sku/./Cihks/vdbTzgwU/AmEEfoV/EPT/../..////	/BdNPYOB/VkH/GuWVNGVUiH/ZsXRpmwsyE/gkr/UVdQl/LTf/LfUr/Sku/Cihks/vdbTzgwU	TODO
mQNI/..///.././ZBQoZQ/iRwqKIZaIQ/pWcjiol/xvOXnEk/../gLuHXfnVn/../lYhcixm/hQrolCkS///../wtco/./////.././uTTAPKZcDz/./WomkigGF/NrMtxNL/ZUfJyzxq/./	../ZBQoZQ/iRwqKIZaIQ/pWcjiol/lYhcixm/uTTAPKZcDz/WomkigGF/NrMtxNL/ZUfJyzxq	TODO
././.././akPDM/XSS/bNvSF/../NfGrx///../LDBWneb/wang/hzCb/mQvBV/Rtk/FOSzJHdK/./npPJFCmGPs/./../../BiTuM/luCNqIbm/iuEYtl//	../akPDM/XSS/LDBWneb/wang/hzCb/mQvBV/Rtk/BiTuM/luCNqIbm/iuEYtl	TODO
///dHJ///./PtCQ///ORnoiJy/oQfYzOQQ/BUyKWCT/pbaKsynvzn/cmEn///./pGZJNWd/../RUqHQgLFAn/wnsjE/./.././TfwUNGJkW////	/dHJ/PtCQ/ORnoiJy/oQfYzOQQ/BUyKWCT/pbaKsynvzn/cmEn/RUqHQgLFAn/TfwUNGJkW	TODO
/LeEUH/./tpxNctxru/./LBZd/./crC/fCyuqENc///nFl/lHy/.///./////./tYNsp///../uSNcrO/../MRaOHrRH/vnfIMQe/./..///././/	/LeEUH/tpxNctxru/LBZd/crC/fCyuqENc/nFl/lHy/MRaOHrRH	TODO
/RWXLF///IYtegDH/./../jrbDX/./emqZvmePno/igJhNtt/ZpOlAhCg/./	/RWXLF/jrbDX/emqZvmePno/igJhNtt/ZpOlAhCg	TODO
///OxI/../yxcDXwcenA/./////mvKWiOlkp/sUkeOKuOW///.././//bLnd/IqHsalxeh/dlN/mnzudyZ/./../dhsk/./..///./BPnOUNmer//	/yxcDXwcenA/mvKWiOlkp/bLnd/IqHsalxeh/dlN/BPnOUNmer	TODO
.././TqDc/..///crQKpztlB/../../././//../../../yymFsMloS/../IuTzxFNj/.///LNNSGr//	../../../../../IuTzxFNj/LNNSGr	TODO
///RXGdpXgl/kXZ/./LPDhwrt/..///./bLZj/OmL/./.././DwUJvkRE/MHCzxywTZ/./..///MotD/NtYk///RCzNgi/..///KmPFp/vsSRC///BHaC//	/RXGdpXgl/kXZ/bLZj/DwUJvkRE/MotD/NtYk/KmPFp/vsSRC/BHaC	TODO
/Xrdpb/././////hNwCYmkxtD/MxFgaObE/././../cPnWzzrh/../../NnZsoJho//	/Xrdpb/NnZsoJho	TODO
.././EtQOMPH/./SLu///../..///././//////HPLUxdZi/../../.././KFSYBK/qrnVL/fsp	../../../KFSYBK/qrnVL/fsp	TODO
/./SmTftQ/IYAHbGBL/UEDmb/iNlYj/yUSaniN/./llOfAZkxg/../../MLWYN/sSljddV/CAx/eReAcXAbq/../vhTund/VCgUUbdd/sXRI	/SmTftQ/IYAHbGBL/UEDmb/iNlYj/MLWYN/sSljddV/CAx/vhTund/VCgUUbdd/sXRI	TODO
/EJtM///..///./iiQXrBmZlW/././.././mEEUv/Huvwb/ICEMrcOJvr///JmbzwLRj/abtLXy///.././KCqL	/mEEUv/Huvwb/ICEMrcOJvr/JmbzwLRj/KCqL	TODO
/OqMpUPmD/.///../././////LarvAqQdb/./TnJwMnBQ/LglvNkJxs/ndKRzuf/tJjtNhZV/./	/LarvAqQdb/TnJwMnBQ/LglvNkJxs/ndKRzuf/tJjtNhZV	TODO
../////.///jiRBezng/../.././../vGPs///././../	../../..	TODO
/PyZwDSEaH/MSHQee/sgGw/././../KgNbIUJT/.///jnaTgL/mtIyX/TubPEOHu/MFffc/./../HkT/./xLFQIpLMl///IrvjWcghLp/cLCJ/./..//////	/PyZwDSEaH/MSHQee/KgNbIUJT/jnaTgL/mtIyX/TubPEOHu/HkT/xLFQIpLMl/IrvjWcghLp	TODO
///PoeIvG/fGvufXvRir/./vAy/../fjWNpw/../sKqm/../Quylu/	/PoeIvG/fGvufXvRir/Quylu	TODO
/./mMIAg/sHUOWW///RVaZmGpHIe///./////././../xojLO/OoQQbUr/./JwnoYD/cbBFwl/oirMMZDJ/../////oYiEv	/mMIAg/sHUOWW/xojLO/OoQQbUr/JwnoYD/cbBFwl/oYiEv	TODO
/looXChKC/smKHztsQvZ/rzkpeebyWm///////KznkixfMNw/.///sWj/SzX/./Bzm/dWadtLye///suBWY/////vBtd/	/looXChKC/smKHztsQvZ/rzkpeebyWm/KznkixfMNw/sWj/SzX/Bzm/dWadtLye/suBWY/vBtd	TODO
/dWHCYC///../QTrlFU/KAfBcRWQn/Nuek/gLK///../../../ZjfFoM/.././//////../	/	TODO
/lazXu/./iHzKJNFQsE/tEqdtr///iFQdHmJpfy/ULIXJ///oDH/xbTsEn/../AivKUJn///../../wofSxIvVqr/tyjWOmlkG/vSDwhiUiJY/ZvGMtLGvIs/ySLJLz/./EltoLlfOgk/UEOZ////	/lazXu/iHzKJNFQsE/tEqdtr/iFQdHmJpfy/ULIXJ/wofSxIvVqr/tyjWOmlkG/vSDwhiUiJY/ZvGMtLGvIs/ySLJLz/EltoLlfOgk/UEOZ	TODO
/oRivnHW///././//../wGlUIwAlCu/.././././//qZhJBzqv///././iqrJS//	/qZhJBzqv/iqrJS	TODO
/tZYZugGRa/../rloyPmCV/./SaX/UJLl/dFrOEjdHYu/./sjmaCSun/zfncMBuZ/././//../../vAs/././AhtWmH///../.././BrvOyERPWx/./	/rloyPmCV/SaX/UJLl/dFrOEjdHYu/BrvOyERPWx	TODO
/./sckbLBZrB/./byQMSj/..///./iKruqHrrfV///hNsmaTWAbX/nBgulpd///./../gngSLFg/Bhyctalll/cBVl/../../////bOqLyyQ///../../../.././///	/sckbLBZrB	TODO
JtAhe/jHrenqnJqk/slOezSyRx/zibeCovo/hicghH/XbQA/./.././../FKyzbe/./KDzqbykJa/zINZQOx/DHWWqh/././//.././/	JtAhe/jHrenqnJqk/slOezSyRx/zibeCovo/FKyzbe/KDzqbykJa/zINZQOx	TODO
/QUm/../OXkIg/../././//TiH///fOwidxAVlI/./../.././gOGYLtw/wKT/zUfzJMIdRI/ZWDcr/yDO/./oxg/./dSg/./..//	/gOGYLtw/wKT/zUfzJMIdRI/ZWDcr/yDO/oxg	TODO
/vRk/../pWt/dRvv/FsDhmz/KhDPvfvtFh/Sjiz/./..///../../RvjCiIoK/../djpSdDTy/WhBKqVnH/..///./../lfYYHPJ/GQgWV/qEVlDHyrdi/fSryXVmV/vgNb////	/pWt/dRvv/lfYYHPJ/GQgWV/qEVlDHyrdi/fSryXVmV/vgNb	TODO
CHH/../../xXwwmxiU/xaMU/..///PuYy/.././../mvlvCXPOe/../iljBGQEsYM	../iljBGQEsYM	TODO
///.///WxA///nPZ/ILkaUObZU/lPKXt/xLYckWbY/.././KhIAPU/../ZXrMK///./ggiVHKTs/bid///./../../	/WxA/nPZ/ILkaUObZU/lPKXt/ZXrMK	TODO
../////./../gzAaKD/IiC/../TRw/Gmss/./././../XjCHCJyuG///CBruDXnf/./CTmXMPAsI//	../../gzAaKD/TRw/XjCHCJyuG/CBruDXnf/CTmXMPAsI	TODO
///jXKX/qjCYxCK/./.././pOUShUpAFp/./cmcrtx/////EmIKHlvu/../pdDQrqCRH///kvpqn/Sofe/./gUXT/../../../QLRQPjt/.	/jXKX/pOUShUpAFp/cmcrtx/pdDQrqCRH/QLRQPjt	TODO
///EoBlVjhB///OXvESisT/hSB/MXixpB/./AOLqBMhoX///./XRgSWiNdj/../../////adJBVwuXMZ/QpRPujOZUP///CXRoQEpDiq///eBJU/xydSZWL/./XqNfGfCjs/././zhjGFT/FBb/oXDjJQZw//	/EoBlVjhB/OXvESisT/hSB/MXixpB/adJBVwuXMZ/QpRPujOZUP/CXRoQEpDiq/eBJU/xydSZWL/XqNfGfCjs/zhjGFT/FBb/oXDjJQZw	TODO
/././CZWGwwE/HcdWWIPnrm/././//SHakUQv///////NftsRT	/CZWGwwE/HcdWWIPnrm/SHakUQv/NftsRT	TODO
..///../BdwEJ/../UmnOm/KiC/./WOEp/../xexqEQpFqs/nRbYBMNek/	../../UmnOm/KiC/xexqEQpFqs/nRbYBMNek	TODO
/////XKyvky/uAvqEKJVrh///../WXQRkTkh/kmSDhayok/////../JcQIC/BbpRT/////../shOaDn/ePVBsiI/.//	/XKyvky/WXQRkTkh/JcQIC/shOaDn/ePVBsiI	TODO
.././LqGYVUk/nZac/../cxzT///wSyOuGix/../.	../LqGYVUk/cxzT	TODO
.././DVpwpiJx/qiTQMpuiF/..///././//./RtS/yyxOzJPxHA/QTVH/BRuVpWYhdV/XOZzN///FcwMu/LULyzc/Ilmelny//	../DVpwpiJx/RtS/yyxOzJPxHA/QTVH/BRuVpWYhdV/XOZzN/FcwMu/LULyzc/Ilmelny	TODO
///./evDR/VbkoJfrftT/rds/./.././.././wBUkqY///fOTkH/.///ZtcAPVar/../Beh/ntmNajSG/lUuCgCkpc/..	/evDR/wBUkqY/fOTkH/Beh/ntmNajSG	TODO
..///../bke/lImQF/./uGNmDy/////////	../../bke/lImQF/uGNmDy	TODO
/DIgJE/NKiPAQBqtj/../TaxfTxZ/ejruD/./KtREkID/YzQKiHygSp/tbNbbCM/RUHK/vYgoSFdhL/bWdotwT///jqwEh/QwL/./../BnLSkOTAaO///../PVXz///ypybsDYyN///NASzXeb/./LHWywui///PBLhQdlow/	/DIgJE/TaxfTxZ/ejruD/KtREkID/YzQKiHygSp/tbNbbCM/RUHK/vYgoSFdhL/bWdotwT/jqwEh/PVXz/ypybsDYyN/NASzXeb/LHWywui/PBLhQdlow	TODO
/eLdF/./.././mTRusBr/DEaeNNGv/Kny/lBEjXcv/ejsBRq/../../../XcjtnN//	/mTRusBr/DEaeNNGv/XcjtnN	TODO
/fdKt/./Emw/RMRIppu/zRhmSylvK/../../AfNrMbAIl///moijMo/arnV/.././DdJRQ/UKJS//	/fdKt/Emw/AfNrMbAIl/moijMo/DdJRQ/UKJS	TODO
/AOtWWJDxO///IQtzSxRm/./../QxOcuyPzS/uIBJSIpb/PPdYwCPXb/ZCuhvgikZI/pKndctuVly///../yahEl/lNV/./hDwJaco/../agGosASYm/./Wzij/../..	/AOtWWJDxO/QxOcuyPzS/uIBJSIpb/PPdYwCPXb/ZCuhvgikZI/yahEl/lNV	TODO
../..///vlSiwmwqD/.././.././rHfiSJdEK/sKjd/CjPw/./QUrGRhMkid///./iaonyFrip/MsUgaoHe/fSQSnAL/////./..///./../GwWBYuhV/JyRzVgf/NAm////	../../../rHfiSJdEK/sKjd/CjPw/QUrGRhMkid/iaonyFrip/GwWBYuhV/JyRzVgf/NAm	TODO
/ueGlkzfzwB/HPqI/HgtZHDPCF/hxSqvI/WNdw/./YIa///RGMtfYf/yzUJOhoqo/MvLEbJCnR/hKGRC/////MBF///./UuwhdPt/sLjORCYxLq/	/ueGlkzfzwB/HPqI/HgtZHDPCF/hxSqvI/WNdw/YIa/RGMtfYf/yzUJOhoqo/MvLEbJCnR/hKGRC/MBF/UuwhdPt/sLjORCYxLq	TODO
.././CxYkQLzi/HgE/TJO///././IXmsGZH/FuqQQr/yNZedZLE/./////FcHTRkP/UjPjh/uBtFvAxHLA/jGbj/zbDMeyXC/.//	../CxYkQLzi/HgE/TJO/IXmsGZH/FuqQQr/yNZedZLE/FcHTRkP/UjPjh/uBtFvAxHLA/jGbj/zbDMeyXC	TODO
..///////./////../zeZ/././MbwEL///YpyVrQZC/ysnWrLyR///././BHeZx///./KCoPcEW/WrP	../../zeZ/MbwEL/YpyVrQZC/ysnWrLyR/BHeZx/KCoPcEW/WrP	TODO
.././pcLqMLMlSF/../PglQI///CKXsO/KGkRpixqOG/MLUi/./NfqlQt///deQYcjA/wuvb/xhmsDM/MnjF/sYRdeNOv/FqTKeMWU/WoTsniVeti///..///..///	../PglQI/CKXsO/KGkRpixqOG/MLUi/NfqlQt/deQYcjA/wuvb/xhmsDM/MnjF/sYRdeNOv	TODO
/PNinBmt/MKl/../lxe/Giqkg/HMUxsjPPAA/eYy///uFAopaNR///.././OYWVoSwZtN/AzcfSIw/sMOFn/	/PNinBmt/lxe/Giqkg/HMUxsjPPAA/eYy/OYWVoSwZtN/AzcfSIw/sMOFn	TODO
ERBL/../../dRbTfP/whV/XFkaUSX/Dbmi/fVqbLmmjNh///fdjfEV/.././//../iXkGMq/sQueRa/../QOxpJCuK	../dRbTfP/whV/XFkaUSX/Dbmi/iXkGMq/QOxpJCuK	TODO
/fCfUAfoFN/QEXQp/IATvnzhE/dbCdFgqUNl/xLvJOW/qeijVFdwsU///hgt/GdE/sFQMwuyCf/..///./SNDsRjx///wgESGTthff/./avWPFy///EFGcvuHBf/CzbJKKraFX/NaKA/Dnl/..	/fCfUAfoFN/QEXQp/IATvnzhE/dbCdFgqUNl/xLvJOW/qeijVFdwsU/hgt/GdE/SNDsRjx/wgESGTthff/avWPFy/EFGcvuHBf/CzbJKKraFX/NaKA	TODO
/./UODCM/././APeEgZpujD///mvwJRqmx/rDOCGG/hSyngl/WFstgzRP///LiFsJkyug/vdvbGNpA/.////	/UODCM/APeEgZpujD/mvwJRqmx/rDOCGG/hSyngl/WFstgzRP/LiFsJkyug/vdvbGNpA	TODO
/vGV///./..///JoEiOyjSY/mdiQFjrftN/lOweDNBOw/MdVVhHsfSd/./wrvUDBhN/WLny/PNf/frDfC/EPy	/JoEiOyjSY/mdiQFjrftN/lOweDNBOw/MdVVhHsfSd/wrvUDBhN/WLny/PNf/frDfC/EPy	TODO
/./mStnfWSf/ozOGPPfey/././//CVt/ExMZh/..///././//cnF/MoyblQTEy///IGQkraRLcV/MmgssV/GKqQGICldy/NJPZJDdmxq/..///./../../VNy/IkGNwaBM/	/mStnfWSf/ozOGPPfey/CVt/cnF/MoyblQTEy/IGQkraRLcV/VNy/IkGNwaBM	TODO
/WHmCiBy/zHeXLs/./FQGoDj///bCTuCoYO/OmGTegcG///././//SeQRUxBwYK/./eFdGHC///BasSfQqibo///./RhRhm//	/WHmCiBy/zHeXLs/FQGoDj/bCTuCoYO/OmGTegcG/SeQRUxBwYK/eFdGHC/BasSfQqibo/RhRhm	TODO
///XvLvYAlPdB/CdjZNZsEb/.///cqic/zdg/eETNVelPy/lMV///sxAnozE/./mFvKSGus///fpupJ/gJsWV/gCbIlBam///lQiK/UcYK/yNkPOAy/hDnYf/sejMYo/////vscGtRzC/../../	/XvLvYAlPdB/CdjZNZsEb/cqic/zdg/eETNVelPy/lMV/sxAnozE/mFvKSGus/fpupJ/gJsWV/gCbIlBam/lQiK/UcYK/yNkPOAy/hDnYf	TODO
../OvsAD/.././../PTNikgUdE/cYBzRwr///olOfQQC/deAHaJVr/./VSLwUHzJ///aWay/iMtX///ZSg///rJyPzSEerO/EdkpwnsZD/moRfl/HIyGmR/mQPv	../../PTNikgUdE/cYBzRwr/olOfQQC/deAHaJVr/VSLwUHzJ/aWay/iMtX/ZSg/rJyPzSEerO/EdkpwnsZD/moRfl/HIyGmR/mQPv	TODO
.///BCMguDNO///gbNIZ/../////////..///lbjE///./../../../../uJDpgqsFv/./EHZpAd///CxJzleUN/./../	../../../uJDpgqsFv/EHZpAd	TODO
/xomdG/../gkUXQqvbA/jgOBXdz///..///IqDBb///////LRRWd/././DQpoGRuG/../PuwkxGh/.///////	/gkUXQqvbA/IqDBb/LRRWd/PuwkxGh	TODO
///nAKejvOk/////..///werY/./ZTEJwS/./OQebHsrmNV/./../..///////TzpcEhp/UfXWiue/vFOLLo/////MhUDxpDzG/..///./ekDHcnjWH/	/werY/TzpcEhp/UfXWiue/vFOLLo/ekDHcnjWH	TODO
/redtEOfO/GKaBT/./PubUKWJG///MaUzKufj/svQ/uLPO/ieOWspurD/qDwVbj/jgRVnoDisA/JVOs/../LvfIOktvw/.///./ORBPflMZfa////	/redtEOfO/GKaBT/PubUKWJG/MaUzKufj/svQ/uLPO/ieOWspurD/qDwVbj/jgRVnoDisA/LvfIOktvw/ORBPflMZfa	TODO
..///////LolcxVLEnl/LTfbv/./../../DfFerKnq///gIks/IPUodXa/././eZg///SkeXuGLzXC/	../DfFerKnq/gIks/IPUodXa/eZg/SkeXuGLzXC	TODO
/XgRN/JjlURQO/coVaALBE/./OOdcVZYlrb///../.././AWCpNDsvwv/GRMdSutP/emGU/.///./../mDsED/./././IHOtdsq/KkRYUzPJ/QKAc//	/XgRN/JjlURQO/AWCpNDsvwv/GRMdSutP/mDsED/IHOtdsq/KkRYUzPJ/QKAc	TODO
///KBOJMDLMW/BqHcFcBsVe/////vdsvVYYgm/..///fhJEVTJhfA/UdYw/duu/..///GeHJF///./KJgbxMJGh/wsTGG///Vjj//	/KBOJMDLMW/BqHcFcBsVe/fhJEVTJhfA/UdYw/GeHJF/KJgbxMJGh/wsTGG/Vjj	TODO
/./jYXHDXWJU/..///kflpR/.././kmga///yyn/../ytTxAU/nzU/bYZfwZmuN/..///IblbAfIoGn/./../pxlF/JMR/ngLwCYPL/yuVoKfoiAI/uJfAPs/./TtypzTl///ennAJaGS/	/kmga/ytTxAU/nzU/pxlF/JMR/ngLwCYPL/yuVoKfoiAI/uJfAPs/TtypzTl/ennAJaGS	TODO
///xtdNKn/jksmfK/CndC/pQPQennQ/././uJrlRhE/UwnjL/psfm/RYsFsCPLk/KMfngyeMni/XhjtLRdcQb/	/xtdNKn/jksmfK/CndC/pQPQennQ/uJrlRhE/UwnjL/psfm/RYsFsCPLk/KMfngyeMni/XhjtLRdcQb	TODO
/Rtn///nNcnpLAaoL/YPIFNYfLw/qOtJnvai/DFMxYss/////uiYxbh/GKP/TRM///nzGrcjXTK/KXotZPXfWa///	/Rtn/nNcnpLAaoL/YPIFNYfLw/qOtJnvai/DFMxYss/uiYxbh/GKP/TRM/nzGrcjXTK/KXotZPXfWa	TODO
/WCYllv/./qIvmfKYB/.///juQuWJ///uiVYNoCKk/./UwZQQdaWTY/GWF/aFGicW/unP/../NMCcNpg/ObJf/wtKOdl//	/WCYllv/qIvmfKYB/juQuWJ/uiVYNoCKk/UwZQQdaWTY/GWF/aFGicW/NMCcNpg/ObJf/wtKOdl	TODO
.././KFSOKrlMZN/././MgimADYQB/MNZJsbNCB///.//	../KFSOKrlMZN/MgimADYQB/MNZJsbNCB	TODO
/rtiytmLz/../XEnaCl///tsHgbsWc///qTUQpDUO/kQoQkivby/TDJz/iQTv	/XEnaCl/tsHgbsWc/qTUQpDUO/kQoQkivby/TDJz/iQTv	TODO
../whyL/ahQEqvV///JfAdEGhn/./gbIgL/HxMAYJiMi/art/FXM/VKRn/./FjEI/qkPt/.///cThlK/wBURgX/IPjEyzl/.///./NeirRYOqr//	../whyL/ahQEqvV/JfAdEGhn/gbIgL/HxMAYJiMi/art/FXM/VKRn/FjEI/qkPt/cThlK/wBURgX/IPjEyzl/NeirRYOqr	TODO
/etbNY/CIXd/DUH/FxUBzRKCDg/.././//yJyKCiJBG/.././.././../zkTyvt/MoPxeUCPgj/../BrYIhx///ycCk/../////././../..	/etbNY	TODO
/HmyV/./////./Sqkxuvdws/hPVj/ROUTiWlkD///QEuFtOfzUB/../lLk/yeQQNZqwSz///././GmeJMsMkj/OefiOO/VJaBLFNuEG/fZut//	/HmyV/Sqkxuvdws/hPVj/ROUTiWlkD/lLk/yeQQNZqwSz/GmeJMsMkj/OefiOO/VJaBLFNuEG/fZut	TODO
DEpWT/../../agJx/lnRHOoY/AfCVtInDd/SIlV/sRW/ZWQADSJD/EQI/./.	../agJx/lnRHOoY/AfCVtInDd/SIlV/sRW/ZWQADSJD/EQI	TODO
/RUY///gwuDA///LwBSqArIhW/cBEiPFBNK/fnX/./bwbjjLbR/hdQ/kCrSCetYmi/QrLnF///..///../../RDQar	/RUY/gwuDA/LwBSqArIhW/cBEiPFBNK/fnX/bwbjjLbR/RDQar	TODO
/UGBMDhh/CfW/PZDnxM/./WauANDK/XgEKLxTyW/./bxwXxzs/././////.///QFGACte/OCdTZtTQx/KyY/../.././//FZXgZDIifX/BwW/../../..//	/UGBMDhh/CfW/PZDnxM/WauANDK/XgEKLxTyW/bxwXxzs	TODO
/sqtbDqNgZv///uKK/../yXz/SkKK/./XHR/.///./pHprMFZjip/../dXtrxGFRW/QYeuukxFJR/zknXMikJ/hnfmpjoy/coHv///WgYgv/FHSExiKGxe/atTNTCcn/../HJaCSx/ruN/.///VBfq/oCZySxC	/sqtbDqNgZv/yXz/SkKK/XHR/dXtrxGFRW/QYeuukxFJR/zknXMikJ/hnfmpjoy/coHv/WgYgv/FHSExiKGxe/HJaCSx/ruN/VBfq/oCZySxC	TODO
/Egjf/../dWNyX/QIbO/CbHeWjdl///QaPBeMyc///QdecaamnL/QiGjt/OGwkkLvZW/////UjSKGuWy/.	/dWNyX/QIbO/CbHeWjdl/QaPBeMyc/QdecaamnL/QiGjt/OGwkkLvZW/UjSKGuWy	TODO
/WoLLArA/ekQjREK/aqdqrppt/.././HwEYTgrKtQ/qPbUSUFOJ/.///aFmSpI	/WoLLArA/ekQjREK/HwEYTgrKtQ/qPbUSUFOJ/aFmSpI	TODO
/AdV/iLIAsXsTox/.///rSk/PbvJvNps/dfy/////../oOVgISMzz/../UPAUeCZV/////pLr/./../xFrqOVtp/..///../YtE/csaYKt/////OCZU	/AdV/iLIAsXsTox/rSk/PbvJvNps/YtE/csaYKt/OCZU	TODO
./../QauAfyb/mpujqDXk///qZmQWxEPER/../////./../OHE/../VpmfYwOQK///gRQPIZoMNr/IHODltH/JQmFJxL/GPRBPCGyq/UpFiBrVZD/../AwWGNU/pCV	../QauAfyb/VpmfYwOQK/gRQPIZoMNr/IHODltH/JQmFJxL/GPRBPCGyq/AwWGNU/pCV	TODO
/./HcRsszVsQ/fePphDC/nNVU/.///./..///AIWZBhx/..///gEBuUlEQE	/HcRsszVsQ/fePphDC/gEBuUlEQE	TODO
acokFLdfn///../../../Fdi///rvmgzEm/..///.//	../../Fdi	TODO
/////qxLEoKtdj/oQNrWteStW/./APhjCdY/fpCh/YMrZHnnQb/xrVlNxZ/cse///.././//../XjOWhjEI/aPw/Ung///FYcRg///FyqYugIFF/jzgwLkZ//	/qxLEoKtdj/oQNrWteStW/APhjCdY/fpCh/YMrZHnnQb/XjOWhjEI/aPw/Ung/FYcRg/FyqYugIFF/jzgwLkZ	TODO
..///LQC/SgpULNNKy/tNbu/////lVkImTJY/ogRmOMR/BScyhpOABN/ffaFezwb/jCbHsqrXX/wHcpvSsPZZ/ldhUqX///./////.///seZxCcB//	../LQC/SgpULNNKy/tNbu/lVkImTJY/ogRmOMR/BScyhpOABN/ffaFezwb/jCbHsqrXX/wHcpvSsPZZ/ldhUqX/seZxCcB	TODO
../../../HxHkklQdv/./ajdCQPWwV/./okdMQllaVJ/./uGaBGPd///./../SCGO///ajmar/oVbz/.././//GFKsnHkHzo/././iMd///XgtIUQLSd/../KfEbg	../../../HxHkklQdv/ajdCQPWwV/okdMQllaVJ/SCGO/ajmar/GFKsnHkHzo/iMd/KfEbg	TODO
./.././zWhsISYG/zzSySe/./CumQylDiAf/.///CKWfzshTkb/../nwHUXl/wnvmLltSF///cgsZYi/./ZcakeBCHu/..////	../zWhsISYG/zzSySe/CumQylDiAf/nwHUXl/wnvmLltSF/cgsZYi	TODO
/IReiRvYOmH///////lha/./npg///////CcmqJm///uCeHfUZ/AyYScmA/PpTLVbripA/CvWrNW/.///./../tDMiDo/tMlEQl/HHphYVF/../WmTd//	/IReiRvYOmH/lha/npg/CcmqJm/uCeHfUZ/AyYScmA/PpTLVbripA/tDMiDo/tMlEQl/WmTd	TODO
/EBJEZhXJ/AJlCCXGJbs/xrCZSpuFcJ/QmqrmIj/.///iEGwfSp/./MKu/avh/./aHLv/WvCHQqurUv/.././IQexPlENf/../HbPUqC//	/EBJEZhXJ/AJlCCXGJbs/xrCZSpuFcJ/QmqrmIj/iEGwfSp/MKu/avh/aHLv/HbPUqC	TODO
/bezktQ/YjSUQqfC/OpBTWWxB/JPwWbuPKc/../hjiJrfYNQ/tJZV/./YsNsIA/../UgnOxxDC///FVakgsdhB///jpnvXWQG///.//	/bezktQ/YjSUQqfC/OpBTWWxB/hjiJrfYNQ/tJZV/UgnOxxDC/FVakgsdhB/jpnvXWQG	TODO
./..///QtcYZpW/HXEDNybaY/qeMvfEhr///./EHyqXO/DJMIjHp/////tReNgGEDW/nTVY/CmneNMow/xJUxNq/JGOkHHH/vZJchuu/MJOlL/WOTf/KDrFlTEjn/////Todu	../QtcYZpW/HXEDNybaY/qeMvfEhr/EHyqXO/DJMIjHp/tReNgGEDW/nTVY/CmneNMow/xJUxNq/JGOkHHH/vZJchuu/MJOlL/WOTf/KDrFlTEjn/Todu	TODO
/DYPtXiLxv///./aJYwU/ZNp/IDieHyn/UwBtt/scsFSJXC/yiqRxUu/.	/DYPtXiLxv/aJYwU/ZNp/IDieHyn/UwBtt/scsFSJXC/yiqRxUu	TODO
.././oewOs/UoB/nWWZz/./../qnVejEqZ/OSsKy/kBVw//	../oewOs/UoB/qnVejEqZ/OSsKy/kBVw	TODO
///iooosnt/../VulOVcN/../ZbiONAKyUd/cieoxlZ/QlQVbf/IzWeKaf/EHG/..///././//lfU///////rmHGVJOX/////dZPI/Bpemdio/../EOOkIYE/	/ZbiONAKyUd/cieoxlZ/QlQVbf/IzWeKaf/lfU/rmHGVJOX/dZPI/EOOkIYE	TODO
///////ouzXMXw/LgvszntM///./../.././////wzD/McxAhT/zVMcnuZUhA///rVMMoHVdkn/../../seadnYWm/cSKYZGqP/jRpR///uorToEYbb/./OpECeuBLg/NPMhIjSxsR///./HjQf///XhqkQEpgSk/UHApQxJgW/RumbN/////./ZXUDxUSu/./KtSvPSg/RCElErhcS/.././YWRvFRzLm///SMkYlfgR/yaww/usrWsSt/cGEctQiLqz///HBvZIU/VnzNhOxZv/TcW/ESmFM/usS/./xABu/zsbCuNTER/eym/../OLtWvL/nKag/..///GzArXZz/xeOCPCqyc/.///kwkRUtPmq///ybaRtFK/LdbHDUbI/femQcSDl/iMQWv/lEkn/././MCZOfwxVi/XzAxNm/../aTgsz///wyYQK///YWS/./ioMaEV/ujZlHO/jKUptlR///../../QLQYkpC///./ePSD/.././//gcBcc/lubAohKJJ/.././jkpKttVs/NmDYd///./../gJIRpZTfNc/vScxgA/lGiMIFWuwg/././wwhCdaUWy/XduhCE/xlK/././..///eUZoXUyp///JiBar/	/wzD/McxAhT/seadnYWm/cSKYZGqP/jRpR/uorToEYbb/OpECeuBLg/NPMhIjSxsR/HjQf/XhqkQEpgSk/UHApQxJgW/RumbN/ZXUDxUSu/KtSvPSg/YWRvFRzLm/SMkYlfgR/yaww/usrWsSt/cGEctQiLqz/HBvZIU/VnzNhOxZv/TcW/ESmFM/usS/xABu/zsbCuNTER/OLtWvL/GzArXZz/xeOCPCqyc/kwkRUtPmq/ybaRtFK/LdbHDUbI/femQcSDl/iMQWv/lEkn/MCZOfwxVi/aTgsz/wyYQK/YWS/ioMaEV/QLQYkpC/gcBcc/jkpKttVs/gJIRpZTfNc/vScxgA/lGiMIFWuwg/wwhCdaUWy/XduhCE/eUZoXUyp/JiBar	TODO
/GejfzbC/////yPW/.///./tGqFeSHd/../ENTcMyAw/../hJMrur/NNY///.///bUoyPCZiG/rjBp/sNvOVah/xOHZB/luS///XpsHED/.././////./../rnvm/htpdnmnUXH/FLo/fVAhc/./.././../NRzNAhkLF/////../UKqXM/././tQzp/..///./..///nOIyqb/////sdXgWK/../tqY/AIZVx///kqpveFK/GIkiJ/oEJUgHBXwL/../wGULuRRhy/../TSBEqC/YJGEqh/vaVpLwKw/../BpMabbFWCi///////././////nPJbyyhvS/////fSlvhZheh/../../nwvI/PzHf/bKTiyW///evxC/../twAbnhPNoU/..///hFw/../////kgzIfOn///wZAnfg///////WjWjzTFli/.///./../eKgkMYCLJW/ghiQcjoOd/YIZ/QMUlNpVPt/.///NnIQ/./../sBwqCXEZg/AsCAOPABZD/ftW/Lid/.././sOi/OigpA/XfFI/./hlq/////////lBNcjpKleO/DjXXrA////	/GejfzbC/yPW/hJMrur/NNY/bUoyPCZiG/rjBp/sNvOVah/xOHZB/rnvm/htpdnmnUXH/nOIyqb/tqY/AIZVx/kqpveFK/GIkiJ/TSBEqC/YJGEqh/BpMabbFWCi/nwvI/PzHf/bKTiyW/kgzIfOn/wZAnfg/eKgkMYCLJW/ghiQcjoOd/YIZ/QMUlNpVPt/sBwqCXEZg/AsCAOPABZD/ftW/sOi/OigpA/XfFI/hlq/lBNcjpKleO/DjXXrA	TODO
///hExc/..///YoxQzK/EtRVonIoN/././XGz/NMD///vbjUMBUny/ARJeSlx/////HNoefDh///../Rbc/SjYRBkec/./../zkWCEfaL/././././TtKjBD///./..///RTJKFoKz/McWssb/gjtZZbTh/////oCEa/dUFvRFrLCg/ZRBetH/./aeFyFNGcpw/jHFQAouy/.///.///okFriDlqQo/tfXjl/////Eyige/nRc/./kVlRrgF/oSXQVGZvNT/../.././//UFyhHJXp/../../mmkqrwLBWZ///zUSuYaIdq/.././../Joa///LpPU///./PGem/lVCcJtqhk/MnjV/../BTHUpy/msjrCd/./fpoC/../wjPR/FfeR/rWLofKcKgq/./dLyuLBwcX/../rUPzFk/./../pYFExPf/gHFKvKH/kCyWZWXU/../wJPwBjQDY/RPpdBmzddY///vfy/KHgmISLE/OsAoPmqJP/sPrf/vsl/ZbisaV///jvAXwz/../oXCqKIj/EQSzlXwYD///iqz/../oKZuWxRb/../PbWNO/twEyCsWEJO/VxkqTD/./kVH///OyNiiJX/MrcF/YSKoWSAxqF/MYgpMdCu/DOZhrIyOJ/.././wTiTPTCAn///.././YZIICmVSRV/ejrdPTpTgj/././//../RdNdEbIv/.///ZzNHrLpvc/DfoS/////../XjSexqtqR/../vxuDB//	/YoxQzK/EtRVonIoN/XGz/NMD/vbjUMBUny/ARJeSlx/Rbc/zkWCEfaL/RTJKFoKz/McWssb/gjtZZbTh/oCEa/dUFvRFrLCg/ZRBetH/aeFyFNGcpw/jHFQAouy/okFriDlqQo/tfXjl/Eyige/Joa/LpPU/PGem/lVCcJtqhk/BTHUpy/msjrCd/wjPR/FfeR/rWLofKcKgq/pYFExPf/gHFKvKH/wJPwBjQDY/RPpdBmzddY/vfy/KHgmISLE/OsAoPmqJP/sPrf/vsl/ZbisaV/oXCqKIj/EQSzlXwYD/PbWNO/twEyCsWEJO/VxkqTD/kVH/OyNiiJX/MrcF/YSKoWSAxqF/MYgpMdCu/YZIICmVSRV/RdNdEbIv/ZzNHrLpvc/vxuDB	TODO
/ijNNkWpg/BasVdTyHt/YUxHy/MaOk/EeGq/EMkfehCfs/./iTIAjjrDW/./kpNGlw///OiBDPQ/XVmsDHZ/wJdORecQ/WcYlC/vZRllyk/aBL/HoY///xWhklyzFSp///NtiqXspqlp///lty///../..///./LKBEBft/hlaPRoRq/..///WkIrbL/pcg/lzjgtGF/jNMv/////DBx/ZEbcWS/zbZlnNN/IhMQUbUb/./ngWnHY/.///../agtbaOhLfk/BCJvFBSRh///mNXhIBBe/..///xfKEqMQf/qqWMFeY/MqB/./EXuzcKfBl/iiAOfnW/../////gVsZBBnQHC/////UBJ/./qsP/gXtuq/dcEI/jnZDHqjzi/rVXwJn///kFCeai/uvrMml/./RuYfTwL/lcKX/AhLksx/iyo/././../////../AVJE/MjtYg/roGEofkz/.///./ReBOn/.///zjmIic/./DQyeIwQs/../fSVuzCw///../VFcm/RPojNFkv/MFRXEFu/iXxYiN/BPxEy///AgMuANH/EbiCgOj/bYw/jngU/../././../eBEcGYP///zowzWeZpzb/../yZthKpBcbq///../////YcbeQ/WRwlvxa///UhkoN/./////aHObUrleMY/../../DyqCBeqya///Mxi/CQc///./zyiavGT/LVQ/aNXEaGk/cqu/../PqejSPNXfC/////////	/ijNNkWpg/BasVdTyHt/YUxHy/MaOk/EeGq/EMkfehCfs/iTIAjjrDW/kpNGlw/OiBDPQ/XVmsDHZ/wJdORecQ/WcYlC/vZRllyk/aBL/HoY/xWhklyzFSp/LKBEBft/WkIrbL/pcg/lzjgtGF/jNMv/DBx/ZEbcWS/zbZlnNN/IhMQUbUb/agtbaOhLfk/BCJvFBSRh/xfKEqMQf/qqWMFeY/MqB/EXuzcKfBl/gVsZBBnQHC/UBJ/qsP/gXtuq/dcEI/jnZDHqjzi/rVXwJn/kFCeai/uvrMml/RuYfTwL/lcKX/AVJE/MjtYg/roGEofkz/ReBOn/zjmIic/VFcm/RPojNFkv/MFRXEFu/iXxYiN/BPxEy/AgMuANH/EbiCgOj/eBEcGYP/YcbeQ/WRwlvxa/DyqCBeqya/Mxi/CQc/zyiavGT/LVQ/aNXEaGk/PqejSPNXfC	TODO
///eHsKc/TmWlWeDrr/tRXphVCku/./../jQMqnvwIzy///./.././ztihjTemlH/../yQRYSINF/DBLRLGh/Pfb/.///SnOIsnaIW/../dVxjLjUR/fUY///././../KnTL///./LPxMMaMvj/..///////xuJ/./PHPCz/CUEft/./hdCPcILgHj/PomQM/nqFJ/QMcHObvYkl/YLJfOqCeO/../fFrUL/../hrbSnSwF/oFVxixopru/lHXqxskVD/../nBUWDf/../RsghgdY/zOU/lXqQxjVB///../kgxuoubpH/OFDITxX/..///../wBcSpr/rNDzCa/uqGwidApv/////././vDRVCKyt/../nCUpPbdh///////././//UOB/tXkHUrO/oiet/DDLcXBn/./../dBmjWH/../../././KtrrVIAM/../../nNzg/./.././jwJopszFS/EiSCpoe/././VTEaYVJLhm/COd/../././tvwXnYjD/nkQ/TGSczpiulU///BmVuQg/RGiOWDKoGb/.././WXTXpu/dmNQbsSpnT/./.././zxuhrV/./wQP/FBzkwrFdYk///////ZOF/pQBmiu/../bNX///BgBaEJPFrD/vEQeMZNny/./AEF/MRl/QHIiigGHnb/GjG/QKkTLv/PFt/.././TGYQKwPU/./jTCmFyMiR/nxOEmfYQoN///mwPDisJ///hSwASylX/fDlY/./EIq/OYWOHW/	/eHsKc/TmWlWeDrr/yQRYSINF/DBLRLGh/Pfb/dVxjLjUR/KnTL/xuJ/PHPCz/CUEft/hdCPcILgHj/PomQM/nqFJ/QMcHObvYkl/hrbSnSwF/oFVxixopru/RsghgdY/zOU/wBcSpr/rNDzCa/uqGwidApv/nCUpPbdh/UOB/jwJopszFS/EiSCpoe/VTEaYVJLhm/tvwXnYjD/nkQ/TGSczpiulU/BmVuQg/WXTXpu/zxuhrV/wQP/FBzkwrFdYk/ZOF/bNX/BgBaEJPFrD/vEQeMZNny/AEF/MRl/QHIiigGHnb/GjG/QKkTLv/TGYQKwPU/jTCmFyMiR/nxOEmfYQoN/mwPDisJ/hSwASylX/fDlY/EIq/OYWOHW	TODO
/SGRp/xrJxE/SjMrMJyVK///QNDqusl/fPxP/SCBwbXL/ibMdPWrHVG/./VRSsNy/QtmOFANj///./..///././../CEPcNEb/LhhRFp///DlzppAP/gfp/geK///viNNEWfz/nqbtEUprK/InVHJwo/////WQujXtTw/./////PdIbLdb/./vWbH///VFHp/./ywvIXqW///ptAA/./BtRJBdSGNY/./fqT/././//./GVuRiCXnDD/XPUQ///OFRKdFRE/qwkmBJc///QeOaEZtpa/..///YmaR/YCMxjKEBSA/rOcKJpUkx/qYxFxcShUA/..///lLFNZSyXw/glCUMqN/./HilzZdJ///LrbOtcTGl/./JOcSwCxVu/LugltAug/..///bcPhRVfP///bmFdkoFI/../UQCz/../lhl/knVwcOlqY/cstdf///dCRTuGbs/////ppV/./HMKbPwc/sBnvuHeYHL/wjZzW/..///qwOOjk/ySWeF/jJKtNnYIpn/gxHayzwy/jNWQkBRJQ/qHl/..///	/SGRp/xrJxE/SjMrMJyVK/QNDqusl/fPxP/SCBwbXL/ibMdPWrHVG/CEPcNEb/LhhRFp/DlzppAP/gfp/geK/viNNEWfz/nqbtEUprK/InVHJwo/WQujXtTw/PdIbLdb/vWbH/VFHp/ywvIXqW/ptAA/BtRJBdSGNY/fqT/GVuRiCXnDD/XPUQ/OFRKdFRE/qwkmBJc/YmaR/YCMxjKEBSA/rOcKJpUkx/lLFNZSyXw/glCUMqN/HilzZdJ/LrbOtcTGl/JOcSwCxVu/bcPhRVfP/lhl/knVwcOlqY/cstdf/dCRTuGbs/ppV/HMKbPwc/sBnvuHeYHL/qwOOjk/ySWeF/jJKtNnYIpn/gxHayzwy/jNWQkBRJQ	TODO
..///HddNMFP/./tPPqpvri/../dyCyoGD///./xIX/bXtCFedM/./rMY/udJK/../IpTbUVKrJt/ZHrASCevP/../umVK/Nxm/ObiE/////////bRLrIjdVSc///./loWnVqF///////ofrOK///KcIqPA/bTjNIcUOG/alaCqyAIz/zvwgxsD/////Ghx///hZXZIyoM/ITPqMxq/./////Xqi///BsMDWfmJj/////..///./../.././woOp/wRP/TaXFBRFSN///ZfcZhlkK/ZLRijIF/../vosltpfnqc/./siThfOPb/qNx/WkrAC/..///KfRPRBf/..///HMcpPVup/./yOehyyW/fVESpHZCMF///./jApViIN/.././WTkspaLDc/OKKNmQ/achFS/ZdFLWg/CvkcXEswQ///./WYygcegp///../bKgXtlUF/FPRnbxr///../../CUZffpWr/fwHaS/.///TvlawgizUC/PbNOkIk/..///olTqjCSskV/./fGLITU/////../iIb/GgrBHTRX/../////DXvxA///.././FeIuTgUt/../../../././//./euLLmKN/Jpuupy/oQBiyIW/./qqHpVKKOGZ/oaASPrvB///./NpdiKw/tHDbELd/PAhEyd/lHCTGo/eakR/.//	../HddNMFP/dyCyoGD/xIX/bXtCFedM/rMY/IpTbUVKrJt/umVK/Nxm/ObiE/bRLrIjdVSc/loWnVqF/ofrOK/KcIqPA/bTjNIcUOG/alaCqyAIz/zvwgxsD/Ghx/hZXZIyoM/woOp/wRP/TaXFBRFSN/ZfcZhlkK/vosltpfnqc/siThfOPb/qNx/HMcpPVup/yOehyyW/fVESpHZCMF/WTkspaLDc/OKKNmQ/achFS/ZdFLWg/CvkcXEswQ/CUZffpWr/fwHaS/TvlawgizUC/euLLmKN/Jpuupy/oQBiyIW/qqHpVKKOGZ/oaASPrvB/NpdiKw/tHDbELd/PAhEyd/lHCTGo/eakR	TODO
/zGfHw///AXS///xFQsKOh///mZFkEYPHR///../////././//qfOwLRWzN///QqZN/./JYepPgtGA/CaMxqel/TRaqjiZ/./././..///rHIGYYfNYL/./RxxkPjcY///////././//////./..///.././RgHUYFw/pqtNCrGKH///EoMeYIpyz/gjZNds/.///ECQjqmS///./././CEer/CoBuifI/./DGcyQtJqy/Dmwgbr/../mtywQ/../CgBdULy/IMTaIHcdB/HfePKB/./KNdDbuCx///./KcX/./OciwLDEG///.///////././../jrrVcje///////////RvMetXHXl/../pfWlfvLZJU/./BTJImJI/.///KJwlVJlwmt/./../HDyNVHZZA/fmhKOS/eQvW/bYDPyMHan/.///YXrmQpaaBc/Nsnqp/PBjEtvWc/ZtSin///.///ezC///Xfrq/utL///JzrOYCXpX/././BMx/GkvyzWfz/./oES///KFwRhRI///UZb///gHAR/LPoFV/tJW///zscjE/vuSLTiU/Pah///BFKsTiygH/tzgsNgnn/.///./okWRH/../neKQFLDv/./../zjyPkNmULX/XAVv/.././//.///SoLjrO/EXpknj///UDS/GSZHnGOf///jCOytjSDq/GRfr/WwAuRoaQa///VvnrZlN/kZtiEOOh/QjkK/.././Jeyn/./FCBaeUN///	/zGfHw/AXS/xFQsKOh/qfOwLRWzN/QqZN/JYepPgtGA/CaMxqel/RgHUYFw/pqtNCrGKH/EoMeYIpyz/gjZNds/ECQjqmS/CEer/CoBuifI/DGcyQtJqy/CgBdULy/IMTaIHcdB/HfePKB/KNdDbuCx/KcX/jrrVcje/pfWlfvLZJU/BTJImJI/HDyNVHZZA/fmhKOS/eQvW/bYDPyMHan/YXrmQpaaBc/Nsnqp/PBjEtvWc/ZtSin/ezC/Xfrq/utL/JzrOYCXpX/BMx/GkvyzWfz/oES/KFwRhRI/UZb/gHAR/LPoFV/tJW/zscjE/vuSLTiU/Pah/BFKsTiygH/tzgsNgnn/zjyPkNmULX/SoLjrO/EXpknj/UDS/GSZHnGOf/jCOytjSDq/GRfr/WwAuRoaQa/VvnrZlN/kZtiEOOh/Jeyn/FCBaeUN	TODO
/OecMt/////cEwlGQwKZS/OKGKtDs/bKyAIjUml/////.///./JbtBXXC/gyLLtsGfx/./////../../GQM/CglZBkp/wRI/////ESot/////.///XlehlemnRd///../WvJIUIdMW/IVrTnBQMB///iEy///../ZKnI/WELrHIEpHf/roABDWVl///tZNvXDHJVA/tfBtnE/.././../DvTnguGhf/lHfylWtWky/dyvxUsae/./owF/aYypRX/ByaXjB/../BRCcEIMh/../drSP/////GxdxVC///YIvznDgS///./..///../LvZmXEop/./VpfmapEgA/WvmCsdWsz/../UbwzKYxfZa///ILP///./HkQP/./kaCAMd/NpyjN/.././abBqMFdofH///bbImJebUqh/HCuJ/./CRsDWKd/OBs///dLiTnEoDWQ///.././SiIXwM///SIrKIVmhKr/./..///../zrDauCoS///woywwGF/CIKutlUT/aWzxCp///LRTYPqZz/./////twAHsUakN/../rRi/.	/OecMt/cEwlGQwKZS/OKGKtDs/bKyAIjUml/GQM/CglZBkp/wRI/ESot/WvJIUIdMW/IVrTnBQMB/ZKnI/WELrHIEpHf/roABDWVl/DvTnguGhf/lHfylWtWky/dyvxUsae/owF/aYypRX/drSP/LvZmXEop/VpfmapEgA/UbwzKYxfZa/ILP/HkQP/kaCAMd/abBqMFdofH/bbImJebUqh/HCuJ/CRsDWKd/OBs/zrDauCoS/woywwGF/CIKutlUT/aWzxCp/LRTYPqZz/rRi	TODO
/sPtOEsdne/TOPePxLVF/../HeGP/wKw/NeDeGUcQP/WZTZS/lAmegJdk/nTgcrI/JxBzPt/////////xUhrjOTIh/riiqmqS/PTGnH/nFumsZlgtn/RVpM/../../jog/wqLulaPdwV/./gddJFBkg/uRRQd///RGZVtxhtmp/./../KEQgW///RLNljvOTX///////Ahe/../qsCWfqAPvP/.././////wCKQpYK/wbPQzpbKL/hBntoHLLY///.././uuTPkQXhar/PenJEwL/./wAeztC/./TDpvuYM/rUv/NGUHujYnWJ/../daVNP/WHzCWCcpbI/GdZUevkJ/twYrWOM///MTXNxMavY/IJtYD///vpEOAa/xXKipK///.///..///FRSziveKb/BTzUfQi///LdrAZbzN/znqtv/../../BasNN/ItPoW/../GLNZskMl///GXCjF/../HuJpwy/UoDtFcgOJ/.///gopPoY///./ElXUtHWykZ/vUNUTnXS/BXXHoM/.///.././tFCgdkCbhd/vNheM///./EFwzlvjGGa/BQcMuZ/BbfJWqdHt/Cvl/faZXpZYq/././//.	/sPtOEsdne/HeGP/wKw/NeDeGUcQP/WZTZS/lAmegJdk/nTgcrI/JxBzPt/xUhrjOTIh/riiqmqS/PTGnH/jog/wqLulaPdwV/gddJFBkg/uRRQd/KEQgW/RLNljvOTX/wCKQpYK/wbPQzpbKL/uuTPkQXhar/PenJEwL/wAeztC/TDpvuYM/rUv/daVNP/WHzCWCcpbI/GdZUevkJ/twYrWOM/MTXNxMavY/IJtYD/vpEOAa/FRSziveKb/BTzUfQi/BasNN/GLNZskMl/HuJpwy/UoDtFcgOJ/gopPoY/ElXUtHWykZ/vUNUTnXS/tFCgdkCbhd/vNheM/EFwzlvjGGa/BQcMuZ/BbfJWqdHt/Cvl/faZXpZYq	TODO
/AthLABt/ZuiGHLt/TPMi/CwUX/pBrVtnkqU/lJwU/HQZ///././//./Gwdj/VDJvR/./egd///////zWsxaXT/tyG/ATYoecOKv/rFAAA///obGWWgYb/////ThsMwtP/UddpQqU///////NUs/wCS/IncKa/fkeaR/QoVwwV/./../../../AOAwAPoWAH/nbhCdhmFEw/ridIV/./////..///././JePakOd///AzQ/./../dpbscmoLyE/./../thYjSYuVl/nQJjhCPyR/////./QMlaFRF///./qIGHHapByw/ahZtEP/YcvEaYDVPa/../././////aegzLv/zAukZLKX/AlUulzyG/ttVLjR/GWGYa/LjOBSxsHNe/..///..///../zRhsne/./uuWv/////pvWxO///./YXjqjFVc/../FJjQ///iNENgvw///MSsd/.././Fvbh/////VcGGRlH/../MrkHHP/Zwibt///../VKSAGtQ/SYyfF/gbi/fEXVQGTwib/QLeoI/./../wdzhzKiFs/../PTvHjHoop/PIbCTIV/./LLuwAyrN/FLvjhIAlr/..///CoEbJ///..////	/AthLABt/ZuiGHLt/TPMi/CwUX/pBrVtnkqU/lJwU/HQZ/Gwdj/VDJvR/egd/zWsxaXT/tyG/ATYoecOKv/rFAAA/obGWWgYb/ThsMwtP/UddpQqU/NUs/wCS/AOAwAPoWAH/nbhCdhmFEw/JePakOd/thYjSYuVl/nQJjhCPyR/QMlaFRF/qIGHHapByw/ahZtEP/aegzLv/zAukZLKX/AlUulzyG/zRhsne/uuWv/pvWxO/FJjQ/iNENgvw/Fvbh/MrkHHP/VKSAGtQ/SYyfF/gbi/fEXVQGTwib/PTvHjHoop/PIbCTIV/LLuwAyrN	TODO
/LqhYGrBSEM/rWfuWXpcA///uAy/QnbDzvcLwF///KkxlkaJ///CMFCKWh/../xYY///jEx/././ALj/.././../SQMjM/../LjPJPbhP/ypsmjHq/pKcc/dTX/zGNHaIa/ewrNykX/meTdh/cUHED/../EQWPM///././SFuoSS/../WKlgeIXoY/EXic/../../../sTJL/YqS/CFbDdS/gXjZeMXUH/.///ZPO/var/CybmyR/..///eguiyXfE/MzxuGeROxL/qPYxG/DjtrGfLgQ/VMR/.././////wTMRafzBUJ///.///fnLr///kQzQw/./jFOY/./../EBPHRSLel/hERnz/../sSvk/.///./gUNJhZxS/pScOKdfzHN///qbjuLXzz/./RLB/DGL/./oYPH///UpzlIabV/./../////BIvVhuQcw/./zJtORB/IcoMAvC/mNzaoJyFOA/HwiErWV/DuBjROKVy/hRuer///UMbd/////bPKpKo/.///./ZGNd/NfTwLQBxew///.///nJIFbQ/AMX/./../MhC/./pttlDzQA/rRxgmsFdOD/./../cgdKzuhz/pPNEdR/VbMRW/NsScS///REWhuL/////..///UriyHJ/qjPUwbPwBG/Dnbu///WWNOH/uMl/QNhsa/jJw/../////tyhGnkISmE/XEUixy///ltCAHRA/Xan/TVcT/woDWga/./../vHxpyZHq/OBcURO/../.././.././wybkvuHR/VudVtUyMyE/MDAkb/././/	/LqhYGrBSEM/rWfuWXpcA/uAy/QnbDzvcLwF/KkxlkaJ/xYY/LjPJPbhP/ypsmjHq/pKcc/dTX/zGNHaIa/ewrNykX/meTdh/sTJL/YqS/CFbDdS/gXjZeMXUH/ZPO/var/eguiyXfE/MzxuGeROxL/qPYxG/DjtrGfLgQ/wTMRafzBUJ/fnLr/kQzQw/EBPHRSLel/sSvk/gUNJhZxS/pScOKdfzHN/qbjuLXzz/RLB/DGL/oYPH/BIvVhuQcw/zJtORB/IcoMAvC/mNzaoJyFOA/HwiErWV/DuBjROKVy/hRuer/UMbd/bPKpKo/ZGNd/NfTwLQBxew/nJIFbQ/MhC/pttlDzQA/cgdKzuhz/pPNEdR/VbMRW/NsScS/UriyHJ/qjPUwbPwBG/Dnbu/WWNOH/uMl/QNhsa/tyhGnkISmE/XEUixy/ltCAHRA/Xan/wybkvuHR/VudVtUyMyE/MDAkb	TODO
..///OnTFcIjQVq/wNxF/JVDfUcZ/oPRdIbd///RqZIjg/yKTQhAK///hpPTXHiD/./dHmEs/Vox/.///.././../../yJvIr/SkEXlUpKi/YJrdfIFJnm///////dJcxaCO/./DvYwywrcp/./hFAYxvlW///////VsoF/.///asF///jtZmHCao/QtRXZlruV/uIjCcZ/.///./../uGA/dlNNM/VqM/./../////./qEe/../VUttF/../MBvzF/ZoEqL/gtRnCAnQD/pccnKReStG/./foHBYDStNV/ZHd/././NHAkCf/////hyE///JWF/./qFibxuC/./JVbGVOiy/XnwLZIch///.///////ckrX/AknYrD/HvZLa/MdutZpkrg/etKabU/////HVkdOeGyJ/./////////shoZXd///SyT/../////chLVNMKuq/fspzoi/lFgQir/gNINZT/dNrd///GJzGjUL/././UmK/lPUAfuhk/DcZxJwo/HIGjL/YwvLNkBOT/CmjWUdMgx/./..///../././RUu///AwVkMByF/../././../JETAKcwBZ/EtjAdEj/LRoCz///bMeY/./ZbpJKu/HRblfOmFS/pIxBh///CnUBsGUW///./vxX/vvbd/..///////sOUGwyjGlt/////wqEahV/../lkGz/./yrMSFVr/iWMZ///oIFvSh/.///GdduLKNz/./wgjJQf/Vya/./OphXYvNzY/UowI/LfHcwAsJ/kGshXIkmzu///../../../../././//../yvCWtR/OdeUQbQl/AzC/VFqcmN/fLXmyOJZ/./	../OnTFcIjQVq/wNxF/JVDfUcZ/oPRdIbd/RqZIjg/yKTQhAK/yJvIr/SkEXlUpKi/YJrdfIFJnm/dJcxaCO/DvYwywrcp/hFAYxvlW/VsoF/asF/jtZmHCao/QtRXZlruV/uGA/dlNNM/MBvzF/ZoEqL/gtRnCAnQD/pccnKReStG/foHBYDStNV/ZHd/NHAkCf/hyE/JWF/qFibxuC/JVbGVOiy/XnwLZIch/ckrX/AknYrD/HvZLa/MdutZpkrg/etKabU/HVkdOeGyJ/shoZXd/chLVNMKuq/fspzoi/lFgQir/gNINZT/dNrd/GJzGjUL/UmK/lPUAfuhk/DcZxJwo/HIGjL/JETAKcwBZ/EtjAdEj/LRoCz/bMeY/ZbpJKu/HRblfOmFS/pIxBh/CnUBsGUW/vxX/sOUGwyjGlt/lkGz/yrMSFVr/iWMZ/oIFvSh/GdduLKNz/wgjJQf/yvCWtR/OdeUQbQl/AzC/VFqcmN/fLXmyOJZ	TODO
/mTaQNP/STdB/ZdcRkL/UHTBrqgtAr///EflWYjilJX/./././IGPko///YtSu/PpsyTG/////xfMVj/../NRqXlI///tpc/KLnuu/./vianzQY/////zxOpaLuje///./bEFtbRANx/./mWEQcwdcZ///fDMpfgt/YPp/./zuwhHUE/../VfLRgFG///././UXqCphYl/vWkYKVcX/..///../iyeO/././WayS/bup///////./uuDVle/TopIlaP/.././ElnmMxS/fhFEoYHd/xvYLpimIkH/qOuNM/zZnqmhOz/ZKdYOuPoxf/oIuFeURkn///./iHRN/XuRBMsHfNB/////.././Vfty/BcGGcOIRG/ilvnpWn/crPngPKu/../../../zKgr/////hRjCsnrEB/wvCyNoqS/.././yHugqN/zEwi/jWgVFlLhKy/GLH/zngkcWOZVc/.///../////kVRvVeUX/./../ZlYFT/MLhuJ/////duY/../mCihwy/..///..///JvKL/////./.././//./../lvlWLy/../../roqvptEJal/jAOKBZl/////AQEPoKzF/IorKAv/.	/mTaQNP/STdB/ZdcRkL/UHTBrqgtAr/EflWYjilJX/IGPko/YtSu/PpsyTG/NRqXlI/tpc/KLnuu/vianzQY/zxOpaLuje/bEFtbRANx/mWEQcwdcZ/fDMpfgt/YPp/VfLRgFG/iyeO/WayS/bup/uuDVle/ElnmMxS/fhFEoYHd/xvYLpimIkH/qOuNM/zZnqmhOz/ZKdYOuPoxf/oIuFeURkn/iHRN/Vfty/zKgr/hRjCsnrEB/yHugqN/zEwi/jWgVFlLhKy/roqvptEJal/jAOKBZl/AQEPoKzF/IorKAv	TODO
/bKEOp/SUTsZEbJu/PtFBAYJh/.///epQMbAl/////bteh///./././qVytLoIyN/../jkDhxOAK///../lPfL///../OdIADJQx/HyHTpvJg///////VqPHmuQkCf/HuT/iZQL/..///./.././//../nVbFziPUA/HKnpfvB///UfuteSa/HOm/LwnGfabvvz/inmD/KzOFx/Bzjl/fsCFGnyNg/LPh/HkiTT/../JcZi/ZtIjAX/./nXo///../oIgNMIL/eMq///////./../../LQYvr/UamHBIyT/Bxq/////././FrVOj/ZBbmZ/..///////phq/IHKwBuHphw/QerXbA/ULj///VDteBFynk/KrrJDM/MIrAL///qxTZYfNYqY///..///ZybHltFZ/fzCUMt/BjceDajzc/./LYsCfBsaS/aCWLiXadBz/iVLsC/MIcO/qxhHOVJGoR/.././////BlttWP/UWTNzPkSHn/ikVa///BIvZBKrp/gRvJV/oBj///mAxXH/RRtw/XThoJZfkKD///gTCicu/./XAqOz///////NqVCRL///./../..///cBJeU/./VtXIc/..///tQENGfpeB///XhCftpgf/./okeLCsFH/../////iqrwUUOQ/rIymOEL/IUnCpX/rftlPi/jSAVjINtRT/../SPR/FRAcQkFon///../GkYx/XGcqK/.///yaWlzsXJ/vskzTt///..///../CmyimvB/./../..///./McOpsIhzd/yepXbC/FxdYzD/NIwdFK///aLus/OeVzcLXNzR/ijpA/.//	/bKEOp/SUTsZEbJu/PtFBAYJh/epQMbAl/bteh/OdIADJQx/HyHTpvJg/nVbFziPUA/HKnpfvB/UfuteSa/HOm/LwnGfabvvz/inmD/KzOFx/Bzjl/fsCFGnyNg/LPh/JcZi/ZtIjAX/LQYvr/UamHBIyT/Bxq/FrVOj/phq/IHKwBuHphw/QerXbA/ULj/VDteBFynk/KrrJDM/MIrAL/ZybHltFZ/fzCUMt/BjceDajzc/LYsCfBsaS/aCWLiXadBz/iVLsC/MIcO/BlttWP/UWTNzPkSHn/ikVa/BIvZBKrp/gRvJV/oBj/mAxXH/RRtw/XThoJZfkKD/gTCicu/cBJeU/tQENGfpeB/XhCftpgf/iqrwUUOQ/rIymOEL/IUnCpX/rftlPi/SPR/GkYx/McOpsIhzd/yepXbC/FxdYzD/NIwdFK/aLus/OeVzcLXNzR/ijpA	TODO
/MoEl/////.///abgBm///JtO/tPHfE/knJKPXdaE/PmMxz/../UbEF/../TwCyBb/./././//hKRMQxDoC/dMSPIBkfiy///./IXlsyYIIla/..///Oyu///nZnR/OnlG/DhRMZ/////rcmSC///dKDgDrR///XiJ/../WTXupPbdom/////yZjsHVUbch/fitC/ZATqmGRpU/Jad/vxtdrF/SxHhBNGL/./AaAjpFX///pGpsebMMr/.///RmZw/gIhRGqJ/../ECqS///./../././../DkGTwLe/.///pPwB/././..///vdrfibDAgg/..///XGB/./.././ZbBGys///vjzyMTi/uPgy///FguuZREWs/.///////jkxEvhJFyL///VpAXhML/KzJKBppS/wIJap/eFR/WEINShiP///BXlLM/jpsmnWzTd///AqLA/iGDGoQL///../iYvbaKkXkf/axR///././XuQKunzqhr/fyBLxTEe/cjgz/./..///..///hDgISNL/./SAzwU/../TbkNCl/.///././VXIWYwScx/yCNSBEG/cpz/wjDhZnGg/xjfD///cvFO/..///XUIq/zbVxWRo/./nXI/TBLlggqVxx/JBJTDSK/MMZGF///vieX/xPJAWz///oSThpXOoN/DfIVAXO/iraP///../EvkZa/././////AJDdCpAGTD/../znYx/./EmE///yVlVgG/////lsUbdxaPev	/MoEl/abgBm/JtO/tPHfE/knJKPXdaE/TwCyBb/hKRMQxDoC/dMSPIBkfiy/Oyu/nZnR/OnlG/DhRMZ/rcmSC/dKDgDrR/WTXupPbdom/yZjsHVUbch/fitC/ZATqmGRpU/Jad/vxtdrF/SxHhBNGL/AaAjpFX/pGpsebMMr/DkGTwLe/ZbBGys/vjzyMTi/uPgy/FguuZREWs/jkxEvhJFyL/VpAXhML/KzJKBppS/wIJap/eFR/WEINShiP/BXlLM/jpsmnWzTd/AqLA/iYvbaKkXkf/axR/XuQKunzqhr/hDgISNL/TbkNCl/VXIWYwScx/yCNSBEG/cpz/wjDhZnGg/xjfD/XUIq/zbVxWRo/nXI/TBLlggqVxx/JBJTDSK/MMZGF/vieX/xPJAWz/oSThpXOoN/DfIVAXO/EvkZa/znYx/EmE/yVlVgG/lsUbdxaPev	TODO
/yhpDZR///TIT///UzhbTUlY/../VYuhMdHs/./LfHaiINOSV/xOHQmUepGN/hNphsmsMC/./JCRPczlhB/lzgnSP/RFtd///KZD/ClV/../TMTYc/pgYvk/////././.././TBizB///..///AeSLLgaYN/qdxtKq/rfq/Ttl/.././SuYJ/././ZMK/fvl/./FvSuLd/.///./zjWbbZ/.././../../..///KZVJ/AdXsuK/gHxPWAABl///////SJsLLfmWw/./..///UsLQPEr///vZpiXQ/../oqT/./../..///ahff/.///iVUvvBnFK///MIX///./FcsSyUvf/WsSrkwa/./qky/////HXaSwBIgYH/./nirwbSh/iAkY/./oYmZkpyrWP/CzPbfQVax/./gfVW/////Hvbs/..///../pdwSfjphdU/../rmqMORyYG/aCU/.././//KecxeH/.././////jbhdfx/TDTlbKJ/.///FnFFrU/./kbTRvUZKNa/wPCFqvuP/vsXAX/ScNrI///./lmzkUz///IFMMNPGxb/JEVzmMIq/NvwpmAjjV/pNHe/mBTSLMvqK///lKSQzp///../ioywXDONPG/../VOvPfWnVo/VJaz/./BHbhmfvrQ/././//bKlbC///PDJvemC///./kRVMj/feZ/./gQPVK///../AxXNh/jHgShYpyE/yhOvC/../////BFI/UsBwtiimS/../rYmDOtixi/VWFri/fmaZkGfq/NgSmdq/	/yhpDZR/TIT/VYuhMdHs/LfHaiINOSV/xOHQmUepGN/hNphsmsMC/JCRPczlhB/lzgnSP/RFtd/KZD/TMTYc/AeSLLgaYN/qdxtKq/rfq/SuYJ/KZVJ/AdXsuK/gHxPWAABl/ahff/iVUvvBnFK/MIX/FcsSyUvf/WsSrkwa/qky/HXaSwBIgYH/nirwbSh/iAkY/oYmZkpyrWP/CzPbfQVax/rmqMORyYG/jbhdfx/TDTlbKJ/FnFFrU/kbTRvUZKNa/wPCFqvuP/vsXAX/ScNrI/lmzkUz/IFMMNPGxb/JEVzmMIq/NvwpmAjjV/pNHe/mBTSLMvqK/VOvPfWnVo/VJaz/BHbhmfvrQ/bKlbC/PDJvemC/kRVMj/feZ/AxXNh/jHgShYpyE/BFI/rYmDOtixi/VWFri/fmaZkGfq/NgSmdq	TODO
/WkSlQl/./fePA/./eKVJT/wRvzCgmQ///GuMYGuR/../XCpWk/./JHHy/gCNWAxmc/.././..///hcpoPAWl///dicdFxTI/..///./../CQhxAJulo/../././oiMCJnBtFa/uIS/ssZXarBIu/rAhsoAixyU/../JARzym/bWe/./hUnGHbK///fqp/voS/./UmB/KDp/UFS/FuRzFiQeU/OskI/RDa///NrTymJ///smchYLGL/YCCXgo/ERW///HzTWvET///xBAklayNYT/xHlMuSVO/eTEaJqeH/iIpk/ubYZL/././wNglypHW/..///uOLX/./DKCkf///PJwVRQMNZd/mitb///../RfiN/../../QrtxZC/./././iATkxYsZIP/////cVSYLQEcR/KtwTGsQ/iJMDagzoe///../../ECudavMCLF///OyiR/JwfAaV/./WbfDjfvD/zVpQTF/tnqBIgr/../OvCeoPGk/jmAQhyE///XlPDIxJ/PILuHj/poyiYtv/GOEOEnKwHE/..///cDveqz/./.././FdRTgG/VgK/sHRdSFk/wFb/./qEGQXtgZQe///..///wTmzdEdAM///dFVSwDwo/../ZzY/././//ZzFvHQ/nZBmJ/AqynCo///../rFUGJOGn/././.././QTWhwn/..///JJH/ECsuLro///bEh/////////xNV/vVe/kUNY/./../QJNcOvKbx///././NulrOu/././EXrNDpuq/Vsoo/qclBPObXd/cYktR/.///./gioXXnO/qdPhmIjSt///EiEUXDBfc/bbQtkzko/./////RbMfGwsrll/mLZS/ynQeb//	/WkSlQl/fePA/eKVJT/wRvzCgmQ/XCpWk/oiMCJnBtFa/uIS/ssZXarBIu/JARzym/bWe/hUnGHbK/fqp/voS/UmB/KDp/UFS/FuRzFiQeU/OskI/RDa/NrTymJ/smchYLGL/YCCXgo/ERW/HzTWvET/xBAklayNYT/xHlMuSVO/eTEaJqeH/iIpk/ubYZL/uOLX/DKCkf/QrtxZC/iATkxYsZIP/cVSYLQEcR/ECudavMCLF/OyiR/JwfAaV/WbfDjfvD/zVpQTF/OvCeoPGk/jmAQhyE/XlPDIxJ/PILuHj/poyiYtv/FdRTgG/VgK/sHRdSFk/wFb/wTmzdEdAM/ZzY/ZzFvHQ/nZBmJ/JJH/ECsuLro/bEh/xNV/vVe/QJNcOvKbx/NulrOu/EXrNDpuq/Vsoo/qclBPObXd/cYktR/gioXXnO/qdPhmIjSt/EiEUXDBfc/bbQtkzko/RbMfGwsrll/mLZS/ynQeb	TODO
/HxrzRiv/KrhSFBOA/.///pzO/BDxb/../yrLAOtiBvZ///./vUBfA/./vxurru/TIIllEU///trsAGRtCeG/AjZQiRGg/././././////JSKdf/dNQsdPE///aoKpXp///azw///eWudbSTDS///oNhOtXt/EWJWV///MEhwZO/RFiHUABAL/./leKJ/zVHcvdnrBP/bTYt/gNuOykLq/lPOpY/.///.///WcaNGDaqOd/OsHQZwK/oPrfI///bubIEuakrE///crAP/RhGm/////jDrID/BsMwvU/WoUcs///meOevak/SwhUNSmku/QvCFIYuL/././..///.///sczsdru///////orQeGptd/oqkK/FLAmVBf/./////KslcLIso///Wqzcpbe///mnyNgV/MGAynt/PBms/////NaJKrznTD/./ZupyUd/GTMzEBGg/.///ESbuQh/////.././XWgf/SfLHdmHRvB//////	/HxrzRiv/KrhSFBOA/pzO/yrLAOtiBvZ/vUBfA/vxurru/TIIllEU/trsAGRtCeG/AjZQiRGg/JSKdf/dNQsdPE/aoKpXp/azw/eWudbSTDS/oNhOtXt/EWJWV/MEhwZO/RFiHUABAL/leKJ/zVHcvdnrBP/bTYt/gNuOykLq/lPOpY/WcaNGDaqOd/OsHQZwK/oPrfI/bubIEuakrE/crAP/RhGm/jDrID/BsMwvU/WoUcs/meOevak/SwhUNSmku/sczsdru/orQeGptd/oqkK/FLAmVBf/KslcLIso/Wqzcpbe/mnyNgV/MGAynt/PBms/NaJKrznTD/ZupyUd/GTMzEBGg/XWgf/SfLHdmHRvB	TODO
/kcO///../kyW/././ejblUNbSBI/./TrWvFfWmwM/lNRYvxNnX/../cLOFjSuAwk/./tAwz/../hOBqOVyi/iXvStYYMkD/sfKcMdS/CPre/BVjHP/egBazq/eFrNvZ/././MmFbmkhN/./hHwtZLHQrJ/../Opx/////YfmRhjnU/.././NAVxca/IDtqtW/mBGZJGkI/FxgiaIA/.///..///././////RwdkTpYV/HauNKlN/../////rcjN/DfVyjzMMvD/AjkzxP/././../../VPjiYJc/bLk/./uXTQeT/VIMLE/////../vKNhIEh/////MvyxEEKtJ/../WdyTl/WSaJrhcIA/../qZSEqOMk/JGYVHAP/IQWGpIxB///../sPX/BSDU/bNutXNKKl/./pFYVwSK/KuHqZit/VkigG/lDfY/LHRMqlM/WacDcVfr/pVvCbi/ZKTvi///./././../../NUMZBeqUGU/../Pku/zxUz/KocpRS/////sOPhYSzT/JHpwTKoe/mucO/.	/kyW/ejblUNbSBI/TrWvFfWmwM/cLOFjSuAwk/hOBqOVyi/iXvStYYMkD/sfKcMdS/CPre/BVjHP/egBazq/eFrNvZ/MmFbmkhN/Opx/NAVxca/IDtqtW/mBGZJGkI/RwdkTpYV/rcjN/VPjiYJc/bLk/uXTQeT/vKNhIEh/WdyTl/qZSEqOMk/JGYVHAP/sPX/BSDU/bNutXNKKl/pFYVwSK/KuHqZit/VkigG/lDfY/LHRMqlM/WacDcVfr/Pku/zxUz/KocpRS/sOPhYSzT/JHpwTKoe/mucO	TODO
/cUN/wguOyEFzlg/////////../././cXZ///./SyexQU/eUajGYecVm/..///npM/GZMzpoiWgr/kRk/ChevHayN/cCDbTXnj///xzYhHa/wRxPkLa/TWeIkhJ/iqnFok/joKcubHyr///qttNskJ///NzHU/KtIpM/lbpuDE/nkb/./syffOfp/FBFJPz/JcqbBkrf/ljKfpEs/ZfqXzSBOwR/////jNgG/bkGc/iakllD/..///.///wwU/././//Oudo/eztiJTJ/slaFp/ENEYau///hSzAaIWIgJ/poeKKoKnrE/hmQJfrlVBJ/../../../uiCrXZgyd/./../././PbGU/./ENJNlwMnf/TbZbt///////..///./////../uDfGataRpR/./////TSiEXylu/./OBnNU///qiqH/.///FmGufrqp///././fLE/////NHegT/umFkjjWC/./QLLpkTyUJ///////KTgMOeKV/XlHmCGJn/../XcuCOoksCv/////FKDbjuZbY///qqHUDmi///../paaLMcZpqG/./..///cDTiA/../USuSLHt/./VCLXzDv/./..///jtixjxhcSh///mComBqaloJ///.././cwFEEN/nSIpGvfXMw/PiuzTxfcW/icENMTro/..///////../../enaKNikz/iHBYSYu/gYYmxTYAI/BoSAnNXIz/./fMRKdPmGy/Cpy///XeXfZKFR/digqibz///tSNt/qJO/../././../UFrlGZuv/fsYUBNZaOb/RRcHg/../bPdTeyQvUt///sfXTHGmoG/MXdqCFBxe/////..///bEqqbR/miTtlqTtc/uqvMDcwzeD/LfZvbDsQ/./yrTr/XHDCfqR///oftf///.././cqfiP///PieRXBVcf	/cUN/cXZ/SyexQU/npM/GZMzpoiWgr/kRk/ChevHayN/cCDbTXnj/xzYhHa/wRxPkLa/TWeIkhJ/iqnFok/joKcubHyr/qttNskJ/NzHU/KtIpM/lbpuDE/nkb/syffOfp/FBFJPz/JcqbBkrf/ljKfpEs/ZfqXzSBOwR/jNgG/bkGc/wwU/Oudo/eztiJTJ/slaFp/ENEYau/PbGU/uDfGataRpR/TSiEXylu/OBnNU/qiqH/FmGufrqp/fLE/NHegT/umFkjjWC/QLLpkTyUJ/KTgMOeKV/XcuCOoksCv/FKDbjuZbY/USuSLHt/jtixjxhcSh/cwFEEN/enaKNikz/iHBYSYu/gYYmxTYAI/BoSAnNXIz/fMRKdPmGy/Cpy/XeXfZKFR/digqibz/UFrlGZuv/fsYUBNZaOb/bPdTeyQvUt/sfXTHGmoG/bEqqbR/miTtlqTtc/uqvMDcwzeD/LfZvbDsQ/yrTr/XHDCfqR/cqfiP/PieRXBVcf	TODO
/QXnJs///./.././//sIcW/../././YncB/qrJikPu/./../../QtvciPN/qirw///CKcmHWJe/YZGD/////HJvaqlhc/lXD///Wbg///DWSrWd/dsB/GjvTBLf/../uiOHfEpJjG/../ricQNkCpq/./..///./../CJwNMdc/////PAxWCQqU///avWpiUNs/QXPG/////./.././qYIM/SQBZHqCwVW/./Dqu///BoB/../lJdp/gIsVxf/TOCIdb/./gqIwroXnT/./BEupzGeaT/qaRsSKPCst/MrdS///./nVAR///../..///psuTd/./kME/ewjAEd/./chjbgN///jxTfFa/LVLrOSCUyf/GmSk/../QlOq/././//quKL/dBOek/./uPLHAD/.././..///hajIvfDO/./WRF///JaKzyb/VyORCWltku///HxD///../////./..///HdpmloMoPZ///JMf/./../vEbIrVk/ALhHTS/../kqhGHrTgw///wlXQhHj/./CfFQki/XQjBBsER/ObcKhGWfVu/////GgSnvVCRW/ZWWhDQA/../SVIqJCgzI/ysKRicVDU///././../AmvRjNKVT/.///../WIpiNiPCCr/././..///pNz/LrjTYeqJv/iMTJwW/qgCYUckt/MXI/////./Sjk/qsaFRsxjJ/CvPbI/uIT/pJHJEveCg///dYnFmd///../wzXXr///QUua/./AfCmKUfi/isimSCAPvv/////./ONVbceN/../lsOKCqa	/QtvciPN/qirw/CKcmHWJe/YZGD/HJvaqlhc/lXD/Wbg/DWSrWd/CJwNMdc/PAxWCQqU/avWpiUNs/qYIM/SQBZHqCwVW/Dqu/lJdp/gIsVxf/TOCIdb/gqIwroXnT/BEupzGeaT/qaRsSKPCst/psuTd/kME/ewjAEd/chjbgN/jxTfFa/LVLrOSCUyf/QlOq/quKL/hajIvfDO/WRF/JaKzyb/HdpmloMoPZ/vEbIrVk/kqhGHrTgw/wlXQhHj/CfFQki/XQjBBsER/ObcKhGWfVu/GgSnvVCRW/SVIqJCgzI/pNz/LrjTYeqJv/iMTJwW/qgCYUckt/MXI/Sjk/qsaFRsxjJ/CvPbI/uIT/pJHJEveCg/wzXXr/QUua/AfCmKUfi/isimSCAPvv/lsOKCqa	TODO
/KQM/////WNaHKoo///gcBtjd/PwIogAK/HxnCeQVaMr/..///./UTGiVYEJC/chbbxLKLm///PdBESCR/DCHU/UNvDTAEKRT/RtKrEswjeD///./CpPOkmtAfl/../././IOu/TMTEe/.././qnOXtLb/./eZnWrFLdZX/DPmGfECZf///vctRidek///qVvJ/gUkxfarT/SidoF///CZHI/../iOlsksu/MILJsyra/HrxINuuXRn/gbTPBd/../nevHJIlYOZ///wcJF/zbFAs///./uUvl/.././eJN/SYpVOY/BOEUlDQvH/./../../////./TJfEWq/.././//.///.///././//..///////././//FiTRdrF///../IspSoWaji/////XYzv/sxiQSQwjx/../../jRLLrKoB///../PYpI/qkVEunn/./vOom/./jmEWIsnex///..///KWHg/nrlcHIZhFi/UxoQAB/xeG///../RyOkoZRj///wTGT/../../////HVXCmpBTa/ccfAd/iFTKlCC/DVXs///IeFR/gDxRuRhaFJ/mqEwh/./Xuxjpfl/mpvC///.///../../PQrLz/eYM/..	/KQM/WNaHKoo/gcBtjd/PwIogAK/UTGiVYEJC/chbbxLKLm/PdBESCR/DCHU/UNvDTAEKRT/RtKrEswjeD/IOu/qnOXtLb/eZnWrFLdZX/DPmGfECZf/vctRidek/qVvJ/gUkxfarT/SidoF/iOlsksu/MILJsyra/HrxINuuXRn/nevHJIlYOZ/wcJF/zbFAs/IspSoWaji/PYpI/qkVEunn/vOom/KWHg/nrlcHIZhFi/UxoQAB/HVXCmpBTa/ccfAd/iFTKlCC/DVXs/IeFR/gDxRuRhaFJ/mqEwh/PQrLz	TODO
/ZJt/./GKFHp///ciiAO/./liKHpPdr/////QGTmWURz/iTE/jRuLnp/qoAJnjY/./bcZZnMKP/eRGBFya///RVIBQV///ckgYjaLtiy/.././YCbR/./../FoNJLCMd/pChXw/RsEfpW/PoVjBgXX/DUUlLCGzqZ/mqbbXbzqXi/naz/SrrqXKmCI///YkvWybPp/////FHs/////./omck/./nSR/CHJPXXv///../CXtshy/../hcGpRiEGx/pCDsCyARy/../RHAfw/.././sviB/CqnX/./JosCLObK///wcmMjKzgVL/.././QwCuKbWS/./JtXcCCsyv///../fchZ///../VSoNoRj/.///./wYRLBe/./IJoab///BHknSjX/./whnJPJXOq/../trcvWwz/../////rTaz/../../vANgzSwouX///.///./CVhejvAor///./../IIbazwzgJ/../KGNhP/../LWFe/////kMbvegZP/TchiRrzo/../mGgqGz/../bNX///bSgiGZrWT/BxzIfzWqpk/././../..///eBFVoSwVy/yPIGluv/pDcKaHT/../FldNiP/////..///.///LDAicRde/./../KzfVSdUAAQ/////HZGGp/././WCaAN/GEPYDpaVet///WKFJk///Tejck//	/ZJt/GKFHp/ciiAO/liKHpPdr/QGTmWURz/iTE/jRuLnp/qoAJnjY/bcZZnMKP/eRGBFya/RVIBQV/FoNJLCMd/pChXw/RsEfpW/PoVjBgXX/DUUlLCGzqZ/mqbbXbzqXi/naz/SrrqXKmCI/YkvWybPp/FHs/omck/nSR/hcGpRiEGx/sviB/CqnX/JosCLObK/QwCuKbWS/VSoNoRj/wYRLBe/IJoab/vANgzSwouX/LWFe/kMbvegZP/bNX/eBFVoSwVy/yPIGluv/KzfVSdUAAQ/HZGGp/WCaAN/GEPYDpaVet/WKFJk/Tejck	TODO
/./OawblFve/ihpgDTpKm/DjnF/CMwt/goNya/../qyZqsKtJXK/ifwNapEkO/eeRi/hJs/ZYf/vbNs/./../xpHLP/./QmRAZL/SgZVVEOhT/mAIZDnL/GBNsVz///.///././Csh/WehxFCwfDB/../IhgR/rDOhHGij/////IQMsbdFcv/./..///HRjt/YaAP///./yTMY/lsDJcfFLj/lxGjgKdb/FFLD/./../aVwhe/../../YXxvrG/dKExVEPhP/WanMXHFF/sfvpMSzxO///FDkyzf/..///szmp/XWgp/WcM/OeWo///.///.///uXIbPe/./dkAhrPyA/mQIsDhi/wJs/YYCLIgCM/YQee/rebLIXANY/../rDC/./../KajcYLjBQ/FCvsgezymR/BYXUDmeNz/RixQfOoHFf///PnlACru/IsyCxx///JTvgyQerG/rDPJwtgQk/./../////FyH/YNsrxj/../aqeUXfX/./miDkVJL/../jXUSl/./CPWmY/tIFPwUT/SHBvQcQ/////./YeqwGoAJ/../wtQNFFsW/tpVZQYRK/sFph/////../////yqya/eUfBIB/wQRqFTG/uBIHm/RUPqscGvz/HKwaFSG/kzAvKsUJy/./../QqUbieh/CsF///meCxo/./../lGRkz/////iQh/JzeVf/NHPyuYNuKq///yKt/bZkQHheiH/imKvMP/QKd/pNyPoN/AORTcOdnyy/./ZtZ/HXJQkc/iYkChu/TajU///flPUhac/.././././jon/./../uBj///hHqYNu///IXGSaOHvT/./ehDC/////../../qUe/iYYutyIDSH/onaXTYYpgk/TJnwmqKVsn/MGruuOnTS/xmxVcUXg/oSNmOmgYov//	/OawblFve/ihpgDTpKm/DjnF/CMwt/qyZqsKtJXK/ifwNapEkO/eeRi/hJs/ZYf/xpHLP/QmRAZL/SgZVVEOhT/mAIZDnL/GBNsVz/Csh/IhgR/rDOhHGij/HRjt/YaAP/yTMY/lsDJcfFLj/YXxvrG/dKExVEPhP/WanMXHFF/sfvpMSzxO/szmp/XWgp/WcM/OeWo/uXIbPe/dkAhrPyA/mQIsDhi/wJs/YYCLIgCM/YQee/KajcYLjBQ/FCvsgezymR/BYXUDmeNz/RixQfOoHFf/PnlACru/IsyCxx/JTvgyQerG/FyH/aqeUXfX/jXUSl/CPWmY/tIFPwUT/SHBvQcQ/wtQNFFsW/tpVZQYRK/yqya/eUfBIB/wQRqFTG/uBIHm/RUPqscGvz/HKwaFSG/QqUbieh/CsF/lGRkz/iQh/JzeVf/NHPyuYNuKq/yKt/bZkQHheiH/imKvMP/QKd/pNyPoN/AORTcOdnyy/ZtZ/HXJQkc/iYkChu/TajU/uBj/hHqYNu/qUe/iYYutyIDSH/onaXTYYpgk/TJnwmqKVsn/MGruuOnTS/xmxVcUXg/oSNmOmgYov	TODO
///ZXaTptQbC/vjdibSmqEB/ylTnmwgU/izvNG/odmuXA/xxo///../mZIT/JgaWXPxuVs/.././kxqyV///./HUfon/xPrN/csDk/nTa/CaDTssnXe/aovnT/xfhuIWQal/./qVAsvwPVG/JBsIw///cgD/QcpnnNKn/.///ZjFaY///../nAzuS///ykRoU/RxmY/../NLkJH/GkaauRFwVW/../../PIai///hbWvU/../ILxWsI/nzUcoo/././VdnE/kUq/./../NoNhZF/////GxYeSwE/IZWyuDjPW///././tUq/../gAHMnKAPoZ/.///../AiJzrEpkZ/aGuIRnXYfc///./hyGH/././//KySVrhFY/AOx/xigoX/./../LGF/sjYCDd/./../IgzzfxocM/QsuUNDdh/gXRCqtMsd/uREuFhWSu/.///TvaYejDJ/mdfNFxkCBt/OTzWf/.///.././gqAwDnvlW/./vSRI/WHmYNZi/.././uYFkVEgMs/../ZVBmJ/KBi///./jpkYsA///OON/Yfmi/WTMophclR/./../JpGbMk/./dXdX///.///FEHJnQFW///..	/ZXaTptQbC/vjdibSmqEB/ylTnmwgU/izvNG/odmuXA/mZIT/kxqyV/HUfon/xPrN/csDk/nTa/CaDTssnXe/aovnT/xfhuIWQal/qVAsvwPVG/JBsIw/cgD/QcpnnNKn/nAzuS/ykRoU/PIai/ILxWsI/nzUcoo/VdnE/NoNhZF/GxYeSwE/IZWyuDjPW/AiJzrEpkZ/aGuIRnXYfc/hyGH/KySVrhFY/AOx/LGF/IgzzfxocM/QsuUNDdh/gXRCqtMsd/uREuFhWSu/TvaYejDJ/mdfNFxkCBt/gqAwDnvlW/vSRI/ZVBmJ/KBi/jpkYsA/OON/Yfmi/JpGbMk/dXdX	TODO
/nIGoAfi/fRji/////cbrbcCFD/kbE/KpWTXTIx/bDrRhCvqB///tefVjm/..///////NVAGcNX/ENKxkzanfg/prfDAQW/quZbyCv/QQJYiWv/..///../Rna///MYJkSr/nDiOQN/../ONmLI/./piEfsehN/NKUxnsiA/./YitvsrQXw/RdfBZua/DsfrcV/../erncXS/IzmyE/vOAdVnCEp/yFakguml/zOHdr/HCxQzGxxHT/.///..///RlJfi///../iSQGJNc/./uZAuYP/qdacfkhIb/kSDoWS///QQwtkC/.///twS/HUf/./jGigxF/wOlHdBLc/ssHbmQeR/DzZYH/FRXwuwKr/////xhSMWGjCKC/Nmq///ObvcvY///cZxMjUA/eeeZouEn/./nkBZkZ/pbfxjeXlQ/./ryLfPsU/hCYuMFerPl/gghvXNNX/../kWY///frPO/WgWDnvnCL/////nmtMHxC/..///./..///uFcaKvlen/QdYEmBaUrv/nIBc/./VdNcDAlP/JmHgjd/ULseZRv/ARxwbLl/./pcVJX///qhBhmjtDK///AsPSXZJrd/uNSQ/../yJMJbGxFK/pMlLy/../pnd/////.///../PRtBVXljX/.///../../YDXOXdsO/../cdRSsMn/././wpSiJJQzT/./qzxk/././eptymYhcMO///AnUYqD/QfPYPy/FeHfvAQelK/../////../OfTekeYRt/////./././.././rWKE/mCuMqUKtr///./HiqN/Fht///ymgZVHjTs///JSVJ/ZxBRxg/BmyAxFNq/../../../oRuuKuil/xoSHlVFGFI/crTC/./EeA/rpDnIhfS/aipTnpEDei/jHtgjBRAV/vrvYjwnGfd/..///../lFmsff/hWr/SnAqzmeBld/../..///ZTdrgoU///VOYSNouI//	/nIGoAfi/fRji/cbrbcCFD/kbE/KpWTXTIx/bDrRhCvqB/NVAGcNX/ENKxkzanfg/prfDAQW/Rna/MYJkSr/ONmLI/piEfsehN/NKUxnsiA/YitvsrQXw/RdfBZua/erncXS/IzmyE/vOAdVnCEp/yFakguml/zOHdr/iSQGJNc/uZAuYP/qdacfkhIb/kSDoWS/QQwtkC/twS/HUf/jGigxF/wOlHdBLc/ssHbmQeR/DzZYH/FRXwuwKr/xhSMWGjCKC/Nmq/ObvcvY/cZxMjUA/eeeZouEn/nkBZkZ/pbfxjeXlQ/ryLfPsU/hCYuMFerPl/kWY/frPO/uFcaKvlen/QdYEmBaUrv/nIBc/VdNcDAlP/JmHgjd/ULseZRv/ARxwbLl/pcVJX/qhBhmjtDK/AsPSXZJrd/cdRSsMn/wpSiJJQzT/qzxk/eptymYhcMO/AnUYqD/rWKE/mCuMqUKtr/HiqN/Fht/ymgZVHjTs/oRuuKuil/xoSHlVFGFI/crTC/EeA/rpDnIhfS/aipTnpEDei/lFmsff/ZTdrgoU/VOYSNouI	TODO
/hgKTrXhKzU/../sguFsB/nyfk/.././//Kpv///WGx///yADj///AstoLyvr/../ofHGLS/vhqfafiYW///./UhHSFEiA///UrsEoL///eTiMnJ/tahx/KcHX/sZx/kToo///uuaRFOkCZ/Oxaunwo/EZpSZUGY/stTvWsHRCC/aDpj/elIBz/.././SctXqRN/hPiWKJ/.///..///EHHslJV/../XauCJxrZcI/./fIO/./////APAdZsRKA/KeBF/.././YGMGKLS/mCJHEZ/moGTaNQzg/htak/./VcwSAyiZ/nlmCgLFMv/./hNCxZQtnv///qoQbZ///.///NUqUgGI/WhGitLeMi/RdSVGxRmB/jFsBBr/..///TIncCIqKs/BFDnIosu///AuaXokkR/./eMCFZeOJUS/FeAY/OtxAif/././//TNEKErbA/././XUHCtAlrR/../yqBJYNvZ///DXy/.././..///lMCVp/////////rto/.///PcIrqQ/./..///rvEMWspUJg/LFgHYQmO/..///////./AjzGrxtZfn/pDxAVhPz///uyb/TVk/ANxN/QpCjOiqVzC/BpotFfhi/MCZppe///./../..///..///ChSGfu/.///QVX/dtW///.///GLTU/../VcYcPUvmaJ/ZfExEc/	/sguFsB/Kpv/WGx/yADj/ofHGLS/vhqfafiYW/UhHSFEiA/UrsEoL/eTiMnJ/tahx/KcHX/sZx/kToo/uuaRFOkCZ/Oxaunwo/EZpSZUGY/stTvWsHRCC/aDpj/SctXqRN/XauCJxrZcI/fIO/APAdZsRKA/YGMGKLS/mCJHEZ/moGTaNQzg/htak/VcwSAyiZ/nlmCgLFMv/hNCxZQtnv/qoQbZ/NUqUgGI/WhGitLeMi/RdSVGxRmB/TIncCIqKs/BFDnIosu/AuaXokkR/eMCFZeOJUS/FeAY/OtxAif/TNEKErbA/lMCVp/rto/rvEMWspUJg/AjzGrxtZfn/pDxAVhPz/uyb/TVk/ANxN/ChSGfu/QVX/dtW/VcYcPUvmaJ/ZfExEc	TODO
/NGlcRya/BwR///./////wgJtQQHMF/./../xTDpjAW/../yqsFFZtW/././OPtonDMf///jibp/////MlrxYPmr/../FeoXba/xqnc/FaR/qfJmq/dNUNic///nZnNgTlQGL/./pSiFin///eaYw/././nSuThSs///.././Nqw/TwMgUsOZro/NUHoDO/KmCWC///BezMT/../pGWkziqiS///Hym/../WxZS/xDqC/gABeIqWF/tyNJChQHqH///ItMxJJ/usGQhrm/UFkAmQkkrG/UJODzvzILs///./sqUwKnu/EuN/iRfv/tCC/Qfdc/RELoJae///////Qioua///JWWcAkoNa/.///uGhKZmELpf/hWRViphW/./.././uKHYGyaGA///../GdyydZ/cqW/ZedYh/./yyoRkrt/./LkADvjEtO/jHCXxlfUL/../HULA///YzHiTwTH/Lugn/././../..///TpSSSbXBF///.././../ODO/././ycX/////RtAwg/MYRdtA/../pkT/MmBkEETW/BqEph/./../SVlywebZfq/XhnPULAab///NkhHlGgJ/../bqyd/ilMGUbskfv///zGVIGw/PpggQzJn/DWkaAbJ/../vVIqx/./vUqwxhjNQs/NfzAuH///./LKfmsgxD/../dXEcV/Edpyseag///HKjVuskurw/riIRPFRCu///../////ovt/PMVnacC/ovKnEqA///POsgtD/../AMTtqTt///./oWjvmorU/APRymvVOy/./XfdIcZ/zsfbRoJeN/../EXGuwZMdOV/jwyhYUWr/krUx///yRDb/ueE//////	/NGlcRya/BwR/yqsFFZtW/OPtonDMf/jibp/FeoXba/xqnc/FaR/qfJmq/dNUNic/nZnNgTlQGL/pSiFin/eaYw/Nqw/TwMgUsOZro/NUHoDO/KmCWC/pGWkziqiS/WxZS/xDqC/gABeIqWF/tyNJChQHqH/ItMxJJ/usGQhrm/UFkAmQkkrG/UJODzvzILs/sqUwKnu/EuN/iRfv/tCC/Qfdc/RELoJae/Qioua/JWWcAkoNa/uGhKZmELpf/GdyydZ/cqW/ZedYh/yyoRkrt/LkADvjEtO/ODO/ycX/RtAwg/pkT/MmBkEETW/SVlywebZfq/XhnPULAab/bqyd/ilMGUbskfv/zGVIGw/PpggQzJn/vVIqx/vUqwxhjNQs/NfzAuH/dXEcV/Edpyseag/HKjVuskurw/ovt/PMVnacC/ovKnEqA/AMTtqTt/oWjvmorU/APRymvVOy/XfdIcZ/EXGuwZMdOV/jwyhYUWr/krUx/yRDb/ueE	TODO
/WRxjBsYAc/rXBXgD/YlK/MCPAnzyw///..///./BNxTorg/DDPgaUpy/ixGGsBlU/Nrxi/.././//BaCRRk///////FOT/../BXd/zqGWdgOwM/////////./LzfrK/jfEILSsPix///../nTGNKOBN/iMGLj/oKblinhNk/OaDXayY/ViQd/RVWUVK/jUex/qZsbI/JJMyxdUkKJ///../../.././../pXU/VGVQM/ohRKRJtuZF/njH/./PJbhjBQYvj/tvuuL/ZGidojvhVE/kqo/.///dgclOStDjn/..///././././//HyvHFx/UIHPXBlc///qXBd/yalB/.///././czwKoIK/vgrQvZ/../ArCq/////.././sKaufcfX/./qmulmxA/UuogszXoj/cQMoakiVJi/./sXTKYT/./TXUPTUqn/uMhoeNRbf/UyfLuB/..///XAjk/yEgdP////////	/WRxjBsYAc/rXBXgD/YlK/BNxTorg/DDPgaUpy/ixGGsBlU/BaCRRk/BXd/zqGWdgOwM/LzfrK/nTGNKOBN/iMGLj/oKblinhNk/OaDXayY/ViQd/pXU/VGVQM/ohRKRJtuZF/njH/PJbhjBQYvj/tvuuL/ZGidojvhVE/kqo/HyvHFx/UIHPXBlc/qXBd/yalB/czwKoIK/sKaufcfX/qmulmxA/UuogszXoj/cQMoakiVJi/sXTKYT/TXUPTUqn/uMhoeNRbf/XAjk/yEgdP	TODO
/aEMYKrV/OWwC/./zIIBYWNIu/ydsGC/pDjV/QjhfZJdUpq/mToY/HWE/..///../igMlBnBm/GNlEafw/dlsUZk/////./fYCqWSN/ELGO/ruY/bVNdJb/PlISADL/UZYBH/RBAyOfYt/legTBcGTua/IGWhLrg/VWVSJ/..///.././MOitjyCz/./../XRWhQhxNIB/./EklQH/./JJFtns/BgJLo///QpGVxAGgi/../trCzoZtN///../PtCzTSaV/zgOE/////PWAqhwQg/../QEnOWz/JqpUE/MTHisK/././//././ZtXkdpNSS///cUMZUfb/GVlgiDda/..///../././MCJ/LRH/zEExT/NSuDZ/JgHsFMbmL/./../mnRToQ/WOAvb/QHJdfisI/BvuaAkc/GXeg/.///yyKmAdf/EAmYh/ESXxqLk/ynwFd/YnY/./rbCbVhg/FpI/../ZnkZhKUTiT/../SvpkBiCA///../././nqWQrVM///cuoRgpvYPX/./xJIwURl/BRIAhUMorl/uXy///./MGvvd/..///ZHhtekES///../UFB/xofZqU/NKgUCsDuHe/DdKL/sZx/./WBhWvm/DiDZdibG/XofgK/xmnuyyIUe///UzbeysWL/./////././////QBLxuxdN/TgZEx/../../////Llwt/./GnpkWqC/../CCkukEUvQf///YOWEU///BcSdpczTa///VpEbJZDQWq/../rQNklSJzht/OswFrQXJg/UcOvZ/QCq/BAmcCMI/////..////	/aEMYKrV/OWwC/zIIBYWNIu/ydsGC/pDjV/QjhfZJdUpq/igMlBnBm/GNlEafw/dlsUZk/fYCqWSN/ELGO/ruY/bVNdJb/PlISADL/UZYBH/RBAyOfYt/legTBcGTua/XRWhQhxNIB/EklQH/JJFtns/BgJLo/PtCzTSaV/zgOE/QEnOWz/JqpUE/MTHisK/ZtXkdpNSS/MCJ/LRH/zEExT/NSuDZ/mnRToQ/WOAvb/QHJdfisI/BvuaAkc/GXeg/yyKmAdf/EAmYh/ESXxqLk/ynwFd/YnY/rbCbVhg/nqWQrVM/cuoRgpvYPX/xJIwURl/BRIAhUMorl/uXy/UFB/xofZqU/NKgUCsDuHe/DdKL/sZx/WBhWvm/DiDZdibG/XofgK/xmnuyyIUe/UzbeysWL/Llwt/CCkukEUvQf/YOWEU/BcSdpczTa/rQNklSJzht/OswFrQXJg/UcOvZ/QCq	TODO
/XZS/ywu/JZzLnQOHxs/YAa///..///.///////.///rPjoiqW/JDUoQJgW///ltAKR/./////../FfRqbC///Yoex/VuW/IWrcRlZre/KFqolngRk/AXJpddN/././lgUK/XOoEkkZQ/SvdeypekVf/ceRy/uDQHkB/../ieJCeafv/gAmUj/QbzufLLTQ///wlhTC///pgXFFFr///..///JXuMZyaU/fNEAM/////CqVoXbmiJQ/../.././LdKFqi/RziJjL/OgqOOfH/DsxgaejRea/KYQheuOt/./../vMqUYul/mdeLCBC/TnGo/.././////nqrBRsmjqc/.///bOqwtoAMW/../ETEV/aLd/.././QxR/AmLVbP/UKvDn/DuDwnqzif/lklG/GoFDSCPc/rHYQ/../awckzWkZ///..///./BpX/WvSZ/.///./////bTyJBQrQGc/sJO/./../hpcay/kUwhzFSrd/jIoWRYh/sNir/ouu/./VZhSt/nBvWtpL/./RMxmp/.///../.././../IbIxVQ/awN/./../ShcGyA/gyZ/sMRfJ/nZUWuN///.././../XyrAfMfreb/./NqGqd/dGdHc///../../NAduzNL/../kHu///../rfxIMsn/rTAIvfyEI/./hyXVs/FRukTszvY/./WDEMqNgg/VLaW/../TDimlYYLMm/tcvCtfd/////./nJjqVBd/ymCTPZg////	/XZS/ywu/JZzLnQOHxs/rPjoiqW/JDUoQJgW/FfRqbC/Yoex/VuW/IWrcRlZre/KFqolngRk/AXJpddN/lgUK/XOoEkkZQ/SvdeypekVf/ceRy/ieJCeafv/gAmUj/QbzufLLTQ/wlhTC/JXuMZyaU/LdKFqi/RziJjL/OgqOOfH/DsxgaejRea/vMqUYul/mdeLCBC/nqrBRsmjqc/ETEV/QxR/AmLVbP/UKvDn/DuDwnqzif/lklG/GoFDSCPc/BpX/WvSZ/bTyJBQrQGc/hpcay/kUwhzFSrd/jIoWRYh/sNir/ouu/IbIxVQ/ShcGyA/gyZ/XyrAfMfreb/rfxIMsn/rTAIvfyEI/hyXVs/FRukTszvY/WDEMqNgg/TDimlYYLMm/tcvCtfd/nJjqVBd/ymCTPZg	TODO
/YwpW/epMkLT/TmnGqDDqe///uknnTQ/pfipkEsd/..///./////jgh/VLcoIypnWn/.///EcM/OgfOdcjUj///vAUEewoOe/./mqXHgP/bkxPPTgo/YBV/../QMkbfMOVJ/.///tTtGYy/EETiRQtNSh///FcUPNGaj/..///viYDXF///bScW/BiKGhR/..///RhqJVohP/./gqG///ZhrgO/bSKCgybpcL/RfLN/XkjjZB/MjNpBODrwg/hLBGugjLt/./CTFkmR///NldTqOx/yWDhhPwe/tdYlArPvMP///BxpUx/////OIjCx///nhqMezirs/////XoWJ/Haup/./BYfVYwX/../././dlw/././QUX/MfbeWmar///oAR/FxB///gOygtHgMPH/////./zleITOZPL/rTDWEDJbt/glUNLfAv///./xLnMTbA/WNdNwCEb/EtDsZ/./../..///sPFEiwNxdS///../////xVNxVvpJjH/Btxlhn/bdBImxKEnm/./XIakAUp/uTHKlOG/rxt/vaxkms/DmxRJbr///DqrbbJcro/.///../Ixfir/QSv/MEgg/oOCF/nXMd/caUkRMU/xGKEaO/CBl/GvyVQTuju///qIx///..///JzIrFu/fzB/dxMGjAaou///GckT/./../ufdmleBn/./../WvulTmoGGx/../XKiGxyAZDI/././JvZhKqm///.//	/YwpW/epMkLT/TmnGqDDqe/uknnTQ/jgh/VLcoIypnWn/EcM/OgfOdcjUj/vAUEewoOe/mqXHgP/bkxPPTgo/QMkbfMOVJ/tTtGYy/EETiRQtNSh/viYDXF/bScW/RhqJVohP/gqG/ZhrgO/bSKCgybpcL/RfLN/XkjjZB/MjNpBODrwg/hLBGugjLt/CTFkmR/NldTqOx/yWDhhPwe/tdYlArPvMP/BxpUx/OIjCx/nhqMezirs/XoWJ/Haup/dlw/QUX/MfbeWmar/oAR/FxB/gOygtHgMPH/zleITOZPL/rTDWEDJbt/glUNLfAv/xLnMTbA/xVNxVvpJjH/Btxlhn/bdBImxKEnm/XIakAUp/uTHKlOG/rxt/vaxkms/DmxRJbr/Ixfir/QSv/MEgg/oOCF/nXMd/caUkRMU/xGKEaO/CBl/GvyVQTuju/JzIrFu/fzB/dxMGjAaou/XKiGxyAZDI/JvZhKqm	TODO
/WIGdVQwl/.///jVGL/./QZfO/tYYsHBjXdr/./Zuc/CxP///./scf/ggNy///ZjdGE/ExLejPy/./uyeYxQcFCJ/Ohl/././NNamNg/TIbneYO/////QcSdAggXsB/NBsx/ymvpGw///.///QxUzibjv/rXSgM/Wzk/////MUbhwH/./HRc/uAEckpRht/..///CLYTnmyg///XvAvgL/isOpPZ/owVNhNLpn/../../noSFE/DTDHdTXT///nhDDlaugE/.///YvC/zORxZAx/met/////.///WSpzewe///../ErbjgAkd/.././../CMH///NJvT/jQD/././//WIWyAvmAmH/clivEBcax/../mYLhlZtbAB/vwo/TSsPFcms/../Zyj/Mgoizm/NHq/./Bqfel///qSFyEmkRE///./////../TOfBKVf/rqWobytp/yiyNOreqCd/./NMBBF/./GAaXTf/./ILRlr/../../NdWZdMiPpJ/bRHVtWVG/rXvXkhU/kVHGp///QTAkZY/./bpjgkDwr/.///./JtnqtMIKP///dlYcg/qrmNf/../ewOuH/uxQfgSsKwF/DbIK///../fTcGrVEsZ/qwnruk/Jeboy///aSVD/MUtvENX/././.././ZWigjVBl/MJr/dkvS/Llegm///ldLtff///jciIBrcWvs///spQRrLxGKY/Wqb/../////../YSVgVbnmn/OIYzmoMBtg/zUK///./ABckJ/TnBrf/..///../nMNyD/////vHET///pAgKufn/././LdtiJBMYmB/sNHjhk/lfDt////	/WIGdVQwl/jVGL/QZfO/tYYsHBjXdr/Zuc/CxP/scf/ggNy/ZjdGE/ExLejPy/uyeYxQcFCJ/Ohl/NNamNg/TIbneYO/QcSdAggXsB/NBsx/ymvpGw/QxUzibjv/rXSgM/Wzk/MUbhwH/HRc/CLYTnmyg/XvAvgL/noSFE/DTDHdTXT/nhDDlaugE/YvC/zORxZAx/CMH/NJvT/jQD/WIWyAvmAmH/mYLhlZtbAB/vwo/Zyj/Mgoizm/NHq/Bqfel/TOfBKVf/rqWobytp/yiyNOreqCd/NMBBF/NdWZdMiPpJ/bRHVtWVG/rXvXkhU/kVHGp/QTAkZY/bpjgkDwr/JtnqtMIKP/dlYcg/ewOuH/uxQfgSsKwF/fTcGrVEsZ/qwnruk/Jeboy/aSVD/ZWigjVBl/MJr/dkvS/Llegm/ldLtff/jciIBrcWvs/YSVgVbnmn/OIYzmoMBtg/zUK/nMNyD/vHET/pAgKufn/LdtiJBMYmB/sNHjhk/lfDt	TODO
../hidXDNdxq/VSveBGgZL/Sdqubgmn/rRq/.///../EOXSwSJU///yaO/DCUezRol///..///////..///..///./AgorEgx/.///../../fVwH/kwYIGfi/wZFXG/.././HoZWH/ijepRQpbm/eYidgz/oDKPPeg///Aebh/../WRQHrLbmvw///oxTdR/TBXtcZ///./RkTVLS/./CEOfkE///RyFaAvGPT///./..///RtKuVjrb/..///gzGn/./././//Dli/YkOAgIvjuP/./qWfotSN///gxn/EqFTAvR///../qABHHNI///FyJBIvlpPE/oCk/../..///////./IkmnGyjE/..///JyhdDU/./XXEAGh/../TovPWm/SzCDzyP/TOtVvAvx///YdEGyIE/VMdY/jaIxGO/styxAtoB/FeSnZlbl/./sRSHj///wWiKhaK/xRuRK///TLkvezva/FOlFqoIGr/yaqLZW/syeJ/../../Fkd/AjZL/wtFRIw/../..///wOrEy/./LGT/.//	../hidXDNdxq/VSveBGgZL/fVwH/kwYIGfi/HoZWH/ijepRQpbm/eYidgz/oDKPPeg/WRQHrLbmvw/oxTdR/TBXtcZ/RkTVLS/CEOfkE/gzGn/Dli/YkOAgIvjuP/qWfotSN/gxn/qABHHNI/JyhdDU/TovPWm/SzCDzyP/TOtVvAvx/YdEGyIE/VMdY/jaIxGO/styxAtoB/FeSnZlbl/sRSHj/wWiKhaK/xRuRK/TLkvezva/FOlFqoIGr/Fkd/wOrEy/LGT	TODO
/./uyVG/KDcsigi/hgUALp/cVwj///wWhLjg/BxAmAgex/UYDwkRSR/eJDQbgyJ/BfbjentdH/EtIUQhSao/vpx/../SEWyRJ/UnFwIq/hmmWpxFHn/pOPnln/nyvSH/AYlFkNL/ocGB///aifvb///sDw///../../sjWKvIyCP/mlQUegSQwa///RAOEq/rEGJMvYwqV/./yfgqRez///eyPjffdYd///./tkUqXuCuaz/tVQQf/../WCGxpaTv/////FTLgRBrO/WYufyeQ/.././vqVLN/../../ZcnI///MlhlgJoi/SwCsie/KyCOWD/../IaJV/DMNAIf/////./oJC/uzyd/goPZvaAk/../NcCAciuNxC/wDts/bDfJqH/sazV/..///../ttSI///qFvTTUlT/UwVA/..///sdVqwcns/////BhtuNLakYV/xzjyUyqdA/BPVz/FcKLjr///CaEB/..///.///YequCUd///FbJRC/hAuQ/EwclX/jZNrUuye/lxsvcQZ/sccY/../QzaNylwLxJ///./LXQjW/RVNFltYt/dxShIa///Dbf/../XbuYsSAyph/../../svvw//	/uyVG/KDcsigi/hgUALp/cVwj/wWhLjg/BxAmAgex/UYDwkRSR/eJDQbgyJ/BfbjentdH/EtIUQhSao/SEWyRJ/UnFwIq/hmmWpxFHn/pOPnln/nyvSH/AYlFkNL/ocGB/sjWKvIyCP/mlQUegSQwa/RAOEq/rEGJMvYwqV/yfgqRez/eyPjffdYd/tkUqXuCuaz/WCGxpaTv/ZcnI/MlhlgJoi/SwCsie/IaJV/DMNAIf/oJC/uzyd/NcCAciuNxC/wDts/ttSI/qFvTTUlT/sdVqwcns/BhtuNLakYV/xzjyUyqdA/BPVz/FcKLjr/YequCUd/FbJRC/hAuQ/EwclX/jZNrUuye/lxsvcQZ/QzaNylwLxJ/LXQjW/RVNFltYt/svvw	TODO
/PCRkcyCH/..///mTQhpNcfB///////./NEMq/////Nqky/IKY/////qMPHwvCoKI/ZcT/../NvBc/./dnpmt/////MIJu///xYsKKFubrc/..///PiIgo/CflyH/YJAqxMpJV/tEFHfOijJ/yVI/mMcUBYj/vcAJsFl/zOXdUoPO///bcNthwzvp/VUyLl/OvazoyFhNq/qiyfCuyFK/bYEIiWo/////QZXL/cDtZFiuvEK///tONHZaY/zJjV/./KjnxWPf/./rPlCPHQgo/EmzH/./GBqgatI/../ScUlk///GHSaE/NDIE/fKnajZ/wEb/xiGZXtuKy///.///cfk/GRCkF///../bPmXxzMF/WiUNtUOftb/////HtpgEWrrQ/zLZbHNgGR///../ceY/../csouSwMGpK/Gbn/./bece/sUTI/.///../iwxS/WCjZAG///POJ/KsNQ/./////aezoBiLODm/../bYcNAFW/../../tPBE/../JmaszRL/RyCZDaQ/..//	/mTQhpNcfB/NEMq/Nqky/IKY/qMPHwvCoKI/NvBc/dnpmt/MIJu/PiIgo/CflyH/YJAqxMpJV/tEFHfOijJ/yVI/mMcUBYj/vcAJsFl/zOXdUoPO/bcNthwzvp/VUyLl/OvazoyFhNq/qiyfCuyFK/bYEIiWo/QZXL/cDtZFiuvEK/tONHZaY/zJjV/KjnxWPf/rPlCPHQgo/EmzH/ScUlk/GHSaE/NDIE/fKnajZ/wEb/xiGZXtuKy/cfk/bPmXxzMF/WiUNtUOftb/HtpgEWrrQ/csouSwMGpK/Gbn/bece/iwxS/WCjZAG/POJ/JmaszRL	TODO
../TIzbIebLtQ/..///iUR/./RkyI/.///..///..///.///wmvtakzOTH///..///VOxWbsC/./../yfWyGX/./../../KzR/.///TeEw/./ZbMfvvKew/YNzn/ZDycJSK/..///jTHTKRxkr/MLDYFNrW/amWTZgL/sLqy/ypP///SWFm/../../CbYg/legrBLekN/yaP/PTwOX///././//../NbSaLWAfM/hEWwa/Juwen/coniMUJHCY/..///../../eHVRsG/../DmdXx/ymE///AXyVFC///./.././ukVCxiFM/HwX/urBArOskby/ddamAoergk/OfIjPLSCR/..///VoItvdrjKl///pGbbD/gpiV/rWJmyOcEce/YJWSqCSO/gkzhIUcmGN/axivDM/../pTxyFrFK///yyoiwJz/KDeddhIomg///EAxfDrCMm/tjvAGDuUMf///sHqGbMWcX/DwhAUwZPcv/DYOVePY/iEzBBCq/qrZaqUDdI/./sqyqikW///pVMsU/UYD/////UoT/CcTqHZfxl/MFJWia/zvvs/lEQoq///./QqXWx/sjW/./XynHIe///./////PVaeVuSFR/RkLwsKh/../IpRJufpEV/hmb///./DYvwHYjWma/./JGQzG/sTpXZMY/OEi/rHw/eBEabjCb///./////pKBQ/./oSg/FmKqn///../vgjzTfrwAg/../.././//cwGIt/./VmSNYUWf///////rpK/././NJFVT///MWj/./jVnSjFUW/mRGUsaQfV/pbNPm/QTRpOtrUL///lCAJix/../DPCuuDbgV/NVLRTFUFjU/cOchEt/../azkCieMNHk///jeaKGklzj/////PykwUR/QQxEM/BMRWWoSj/../kcT/usDdGWCb/./THkYd///jMb/./.././//./KkDOMFtM//	../../KzR/TeEw/ZbMfvvKew/YNzn/jTHTKRxkr/MLDYFNrW/amWTZgL/sLqy/CbYg/legrBLekN/yaP/NbSaLWAfM/DmdXx/ymE/ukVCxiFM/HwX/urBArOskby/ddamAoergk/VoItvdrjKl/pGbbD/gpiV/rWJmyOcEce/YJWSqCSO/gkzhIUcmGN/pTxyFrFK/yyoiwJz/KDeddhIomg/EAxfDrCMm/tjvAGDuUMf/sHqGbMWcX/DwhAUwZPcv/DYOVePY/iEzBBCq/qrZaqUDdI/sqyqikW/pVMsU/UYD/UoT/CcTqHZfxl/MFJWia/zvvs/lEQoq/QqXWx/sjW/XynHIe/PVaeVuSFR/IpRJufpEV/hmb/DYvwHYjWma/JGQzG/sTpXZMY/OEi/rHw/eBEabjCb/pKBQ/cwGIt/VmSNYUWf/rpK/NJFVT/MWj/jVnSjFUW/mRGUsaQfV/pbNPm/QTRpOtrUL/DPCuuDbgV/NVLRTFUFjU/azkCieMNHk/jeaKGklzj/PykwUR/QQxEM/kcT/usDdGWCb/THkYd/KkDOMFtM	TODO
RzE/../.././XkDpJvpa/aho///kapiDCI///WgcGoo/boPHnlvP///.///gfw/./FVKmnRcKt/TcIO/kTLmCBSP/VymNMy/./MCyGc/LEqvhLlXJg/../qwmV/LoFJWVoDC/./////VREPpgmGk/LtPoIJRpIM/YLGTw/////LCcyUV/../wJTA/wjXoCrbWD/TqlrFf/../../epN/FdOZluDywf/./../HtVJv/./OiD///LZRGRvnbP/uMMwfkpE/./../../lVOEJvGqFi/JnbpLPL///XYuAHLiqAZ/vDlFaYkel///kYwgly/../YBcomD/awJarInU/lUxeJHr/FFovmt/././NmTppk/./zGdcUknFFW/TXw/xBIoAd///Hwcpl/../QBPq/sPeGRycBe/dOsRuqQ/SrOf/iyc/./XsYq/..///TmrxFvZxS/itza/../foLd/././////aocpFR/TOrha/cHpWvmStby/fnjsMg/gyN/VVK/AtHs/../fNyvEQ/../eKpci/FeTK/../gUhFzF/gruW/////VSsG/qKamzTG/GxuZUqKMvn/./YCcEx/enSspg///////../jaBGD/TwurJZC/././YPA/bJfhrNoL///..///../dxeVoVv/mKfYZcd/vZbZnd/oiAkWtGp/../././fybjXObEh/PVbVBV/./zOlpcdwT/zCENvPZRJ///ENzCxrb/JghIuvU/DkIvns/ipXT/qihXXV/////../xLV/lVVuuwZh///..///.././apy/AaKDvV///./VUJux/adCubAgOeQ///UQzvJNm/whm/./rOCNiEEvPg/	../XkDpJvpa/aho/kapiDCI/WgcGoo/boPHnlvP/gfw/FVKmnRcKt/TcIO/kTLmCBSP/VymNMy/MCyGc/qwmV/LoFJWVoDC/VREPpgmGk/LtPoIJRpIM/YLGTw/wJTA/epN/HtVJv/OiD/lVOEJvGqFi/JnbpLPL/XYuAHLiqAZ/vDlFaYkel/YBcomD/awJarInU/lUxeJHr/FFovmt/NmTppk/zGdcUknFFW/TXw/xBIoAd/QBPq/sPeGRycBe/dOsRuqQ/SrOf/iyc/TmrxFvZxS/foLd/aocpFR/TOrha/cHpWvmStby/fnjsMg/gyN/VVK/eKpci/gUhFzF/gruW/VSsG/qKamzTG/GxuZUqKMvn/YCcEx/jaBGD/TwurJZC/dxeVoVv/mKfYZcd/vZbZnd/fybjXObEh/PVbVBV/zOlpcdwT/zCENvPZRJ/ENzCxrb/JghIuvU/DkIvns/ipXT/apy/AaKDvV/VUJux/adCubAgOeQ/UQzvJNm/whm/rOCNiEEvPg	TODO
///CyQZ/../wOXrzw/./DAVftDeX/pWvGdQEh///chhKXKCb/./../pOCaoLhX/NLf/NpDl/BPrXhX/./YcCcPppKGO/././uPkweRAOgY/./UTIYpQI/.///iia/./defttS/./uKuj/../////SgN/././qppGhO///flhPmL/./..///LELWhGDbGf/./uSt/../ukaqw/////sTeKbTRI/GZLn/MCXVFsTO/../../XhUa/./LiXLqmOoMe/JmBc/./../../bARAL/./////./IjVhIa/pGJKdlNbAl/ZFMX/wyMnj/./..///OkVMcVeBrE/FsJeOJFhAa/tkQvjxH/dAWVGTOnQr/../Mad/jhtUa/ggDdvQqJ/..///pdVGkXOH/wte/OLRUUdruOQ/xPRcB///aINRbK/lneuKgzm/MgGRNSLE/fdFniBh/qEp/JhgWPi/mKealhezlB///JEM///../aYEWu/../../././ELW/CxmhF/VSQs/../../../.././vVi/flmxgSkI/../ANCJg/../GbBsvE///gUyKxvq///////HEI/gCB/aaf///..///../IwfdtEdtbJ/.././ZDdL/rFjdmTHmPn/../jmujMpQ/..	/wOXrzw/DAVftDeX/pWvGdQEh/pOCaoLhX/NLf/NpDl/BPrXhX/YcCcPppKGO/uPkweRAOgY/UTIYpQI/iia/defttS/SgN/qppGhO/LELWhGDbGf/ukaqw/sTeKbTRI/XhUa/bARAL/IjVhIa/pGJKdlNbAl/ZFMX/OkVMcVeBrE/FsJeOJFhAa/tkQvjxH/Mad/jhtUa/pdVGkXOH/wte/OLRUUdruOQ/xPRcB/aINRbK/lneuKgzm/MgGRNSLE/fdFniBh/qEp/vVi/GbBsvE/gUyKxvq/HEI/ZDdL	TODO
RgqFqiIxaR/..///..///../../OPcqkqCZ/xDpAvw/PsJMpRD/GxneChk/.///UxOisepKs/../Muhzvb/.///CVfPbsf/sYQ/LFz/./zYvkw/////Juze/oGtURUPKq///////MBe/QVzs/./vAUZbKs/MQOpJK/////wPeZ///qbNgNbjAE///dWtdb/./ijOyxAvdc/ZzUhlzoXp///qkPImu///YLOWQYUPsN/IjzSTglh///VgjLHASbDH/./wFcryDr/./EMlWiSl///RQxxc/////////ocfWIA/QgAC/pQpGSZEgJL/aInwKNYug///YBeH/VSVijQaG/MuxXqvdxU///../UPwQoFCvdq/Xto/././..///../../wYkwQ/.././../xMxD/EGQRKGHmW/////./NZR/////VPZoracQr///tzvwZihIF/AHrYDYmMi///TFdkFZRFf/eKE/fyLWQzqO/.	../../../OPcqkqCZ/xDpAvw/PsJMpRD/GxneChk/Muhzvb/CVfPbsf/sYQ/LFz/zYvkw/Juze/oGtURUPKq/MBe/QVzs/vAUZbKs/MQOpJK/wPeZ/qbNgNbjAE/dWtdb/ijOyxAvdc/ZzUhlzoXp/qkPImu/YLOWQYUPsN/IjzSTglh/VgjLHASbDH/wFcryDr/EMlWiSl/RQxxc/ocfWIA/QgAC/pQpGSZEgJL/aInwKNYug/xMxD/EGQRKGHmW/NZR/VPZoracQr/tzvwZihIF/AHrYDYmMi/TFdkFZRFf/eKE/fyLWQzqO	TODO
///mGKMpSi///vPDG/./././bfmy/../////qTsEnY/.///XzDeOI/yJEy///../cxOZVClXZL/yjB/JLC/////jlqCSI/./../yADaDkzxwg/wEnvQ/../TTgpqBSKa/LExrNucmJH/pDNZWbWWi/gUwcf///././../UAljhtviVM/cmJpBEFCQO/////////nHTFZ/pnAyQ/liA///./YvnT/khSwELJDy/////GhaPztrwqC/////////FlMz/Nosns/Lga/vNq/yEZcKc/vFVvjZGxk/JBkDiML///PpEDo///.///./////yMkFayzG/qfwNj/XXFQyLoOUw/MGORdofr/RhAlYZ/ZQF///yjzgRiYKc/./dGpBEL/./ZgYeRKwlE/////./././duipdHOl///RlnqoCrXHf/iYaGYZNBVl/../Zevy/NxjDfNFO/pzflTXuMm/psumRcniQo/../MoxwRkbUWb/sIRd/aDskXCEqO/YKmh///UhqNtdxs/rye///./GppMz/////./././WNIhIdG///./vrRT/VcbJWIKKac/////afMrDv/ssnNRPM/dHcWJBt/../PYOtJWb/DbdQagLVF/cyFnendRR/KAqE/CtEzGkoH/adb/ORVtouDWCi/../nQKNmnagn/PwL/../VKEkR/jzjrtT/oBpCwgKAGP/RWpyH/kIQDekdqX/ZrHtnA/ZAp/JuRzMJhwPP///EVZ/UnieCr/bslDP/JbjjPR/WMREpKoHB/../YdxWDfiIO/./yTEgySNJ/../.././//CiM///RKGe/krexBKKpa/YYuljpJaA/cWjJJJlNEg/./UEsFHBr/WROsRrFsos/////././SbTSTiAto/./aopazsNMx///dnpg///qCYm/UznttA/cGyLyWME///.///qpApAHLZ/.././vhYM/xFcihdS/	/mGKMpSi/vPDG/qTsEnY/XzDeOI/cxOZVClXZL/yjB/JLC/yADaDkzxwg/TTgpqBSKa/LExrNucmJH/pDNZWbWWi/UAljhtviVM/cmJpBEFCQO/nHTFZ/pnAyQ/liA/YvnT/khSwELJDy/GhaPztrwqC/FlMz/Nosns/Lga/vNq/yEZcKc/vFVvjZGxk/JBkDiML/PpEDo/yMkFayzG/qfwNj/XXFQyLoOUw/MGORdofr/RhAlYZ/ZQF/yjzgRiYKc/dGpBEL/ZgYeRKwlE/duipdHOl/RlnqoCrXHf/Zevy/NxjDfNFO/pzflTXuMm/MoxwRkbUWb/sIRd/aDskXCEqO/YKmh/UhqNtdxs/rye/GppMz/WNIhIdG/vrRT/VcbJWIKKac/afMrDv/ssnNRPM/PYOtJWb/DbdQagLVF/cyFnendRR/KAqE/CtEzGkoH/adb/nQKNmnagn/VKEkR/jzjrtT/oBpCwgKAGP/RWpyH/kIQDekdqX/ZrHtnA/ZAp/JuRzMJhwPP/EVZ/UnieCr/bslDP/JbjjPR/CiM/RKGe/krexBKKpa/YYuljpJaA/cWjJJJlNEg/UEsFHBr/WROsRrFsos/SbTSTiAto/aopazsNMx/dnpg/qCYm/UznttA/cGyLyWME/vhYM/xFcihdS	TODO
/phRT/./////../CEbwJpbKHG/ZdVFgTTsg/WWtpot/.///../////EHS/osxHrTbJiX/./oSLcF/isMU/GDe///pbmHIZJdL/////.///./MQQhtAY/gNgiRqLNI/JsI///////fMNIYXh///////././..///./HcJgWJSmXt///RsqIRmIxol/..///xViXf/iRF/./ztI/ExgQdLMcXC/swz/./../../DnhVzT/zyAmsX///.///./OGEPrPVAM/nrmVDCA/////.///lvf/pZoRWNGOoS/ctzCS/aIqp/.././..///KbzjiaUa/tfH/.///../JnANb/./utPFiKWmVZ/././alMxpvQnB/./bTVfAty/.././XChHa/gxX/ThYdIXjcX/././//../iMrYkLDH/OrImxLHf/OYq/Nsw/iswLvV/XKjyyY	/CEbwJpbKHG/ZdVFgTTsg/EHS/osxHrTbJiX/oSLcF/isMU/GDe/pbmHIZJdL/MQQhtAY/gNgiRqLNI/JsI/HcJgWJSmXt/xViXf/iRF/ztI/DnhVzT/zyAmsX/OGEPrPVAM/nrmVDCA/lvf/pZoRWNGOoS/KbzjiaUa/JnANb/utPFiKWmVZ/alMxpvQnB/XChHa/gxX/iMrYkLDH/OrImxLHf/OYq/Nsw/iswLvV/XKjyyY	TODO
/////rwtUoSxh/.///GWBA/APFJ/egelbTiWd/./TJX///ArYxePMo/PTjbyiLLv/./OCeKqx/hJzshUdfJ/./inPACZ/mJEKkBL/GmbhBL///././RulrXnlB/CBosS/flRWjEKK/gQr/../lzmXpkpgD/../JjuXzCClB///../../ajDDdAiRI/./../pnu/.///Qms/../bysUThoe/HAjtPlc/HvMl/dcqVy/./bHOlEZXPJe/WPVpnJsjAw/HcyVxogO/tAlDLRROzC///////dVSG/KMIlFqP/ABP/vQWzpinTFt/../Vtvt/LCervNXSHV/xxTmEz/WbWjhL///doBoxS///////UQLpM/../fvSK/./RFJn/./../dgNeEqdee/FFX///../LQRCymv/cFj/tkSWJKG/../..///./oHtYOZ/DzCFVpnM/AgYr///./amdXWNE/../VDt/./..///gGcbaYanqK/yQIu/CnD/VQhm/././//cDXQZ/././dTNdUTf/.///././gjvmpmmYn///../../xJVfOT///.///lPUg/utFWsJNY///lxMLOfSm///././kxSkmomOX/./oPubJ///////emeToNX/MDVLGqYY/pTV/wjC///./qZvEnSARya/ycFC/GSWwkmQMiI///eYMJIPgC/	/rwtUoSxh/GWBA/APFJ/egelbTiWd/TJX/ArYxePMo/PTjbyiLLv/OCeKqx/hJzshUdfJ/inPACZ/mJEKkBL/GmbhBL/RulrXnlB/CBosS/pnu/bysUThoe/HAjtPlc/HvMl/dcqVy/bHOlEZXPJe/WPVpnJsjAw/HcyVxogO/tAlDLRROzC/dVSG/KMIlFqP/ABP/Vtvt/LCervNXSHV/xxTmEz/WbWjhL/doBoxS/fvSK/dgNeEqdee/LQRCymv/oHtYOZ/DzCFVpnM/AgYr/gGcbaYanqK/yQIu/CnD/VQhm/cDXQZ/xJVfOT/lPUg/utFWsJNY/lxMLOfSm/kxSkmomOX/oPubJ/emeToNX/MDVLGqYY/pTV/wjC/qZvEnSARya/ycFC/GSWwkmQMiI/eYMJIPgC	TODO
///xqbB///bAEgt/WXY/mjoByRP/eBkyjOboa/////DfzMs/LWsVVz/./ajSuMF/qnUccBp/adPrYVp/jzd/./..///dVMAX/./../rlaRxTyByI///jic/./mBrBH///././//tTj/rczaVtAXf/./gdWtWADhq/../PUS///fDL/otQLSTosZp///erFHP/////SzocDuwE///SKPqY///../GAwPcQR/MOcMt///acLe///dzzekshbrT/MyprZC/mWRQInTu/iSakts/../nEjoeL/SGONtDBXQM/hFdRNiQoR/././mVMws/wcIkpspFeG/../yNZahWbzNN/fYzaOXiSR/FUBK/OPzMjQ///./sxFE/./uutcnBfXes/././//EaUXq///..///fSFajKu/JwFT/eWFHa/DGT///./////../KdYUhoh///..///./pLaVuRU/lagW/SptSoD/..///jhzkOfd/..///ExpnO/qFxVV///kYDl///HZm///NzCQf///Lxa///WHvJqci/HVkBjFOz/oHfrQ/../bVneXpl/..///./pZA/UHH/../../KYWspeiwBV/../jlzrgUH/../qdPTIS/./././//RKtagr/.///hMpzvetcR///ygfEpE/PRmb///.///pQxUhiqt/.///lpuFvT/../.././qwUP/VevafR/../MXRdSUfvL/jOzScBxTG/./..///McLo/DUAaUmSrS/./qhdW//	/xqbB/bAEgt/WXY/mjoByRP/eBkyjOboa/DfzMs/LWsVVz/ajSuMF/qnUccBp/adPrYVp/rlaRxTyByI/jic/mBrBH/tTj/rczaVtAXf/PUS/fDL/otQLSTosZp/erFHP/SzocDuwE/GAwPcQR/MOcMt/acLe/dzzekshbrT/MyprZC/mWRQInTu/nEjoeL/SGONtDBXQM/hFdRNiQoR/mVMws/yNZahWbzNN/fYzaOXiSR/FUBK/OPzMjQ/sxFE/uutcnBfXes/fSFajKu/JwFT/eWFHa/pLaVuRU/lagW/ExpnO/qFxVV/kYDl/HZm/NzCQf/Lxa/WHvJqci/HVkBjFOz/qdPTIS/RKtagr/hMpzvetcR/ygfEpE/PRmb/qwUP/MXRdSUfvL/McLo/DUAaUmSrS/qhdW	TODO
/TVRE/././haGtvOs/../PBEUv/banrUwU/./GlTCNVkKb/OPjIEsXB/HpppyVT/./xkE/////../anb/cQq/HWX/./flKovxds/FlaQSSD///foXENSmNVI/../udVIqjK/LsFWvQA/chpsxVw/bgr/BesIaBCo///../../iBE///..///UHNgWj/vZoFLyg///HKzMSaa/../../eysmbJa/rveOjmAh/sRSyceBs/./aYKtJi/votrXL/./OxkGuYRu/Esxo/JuX/QSDIxny/../../HaKWvkFbuV/hAF///.///////JtNxtrzQif/ZJnToX/wClYbmGVf/././../orC/../RwlyIufMg/nONJU/UhKjJ/GGQmKKBs/xXf///ZjeSnLfEKX///DZZgCYBREJ/eoK/../oQSEp/./..///DNi///XqXUTuTXk/////LAXn/../../JjQb/mDcZCeSs/MtaQOkk///NZziRxK///XISYCNe/.///////Qbx/aEXeQvhm/EGHFhcGGJT/NDPUxCCoz/KtGvWODVVU/////tvEL/hOfKDFcrK/SOO/XLcJy/../EbLHyhdOR/xDDQb/.././EGircJdzPx/./comEsg/MfWloBhvj/gOCNnagvRz/kIOauipBl/gFqIO/ABdwR/./mAvc/joH/.///pFQ/../../KGppQEst/////HwZvfiez/AoKHtGvkx///../	/TVRE/PBEUv/banrUwU/GlTCNVkKb/OPjIEsXB/HpppyVT/anb/cQq/HWX/flKovxds/FlaQSSD/udVIqjK/LsFWvQA/chpsxVw/UHNgWj/eysmbJa/rveOjmAh/sRSyceBs/aYKtJi/votrXL/OxkGuYRu/Esxo/HaKWvkFbuV/hAF/JtNxtrzQif/ZJnToX/RwlyIufMg/nONJU/UhKjJ/GGQmKKBs/xXf/ZjeSnLfEKX/DZZgCYBREJ/DNi/JjQb/mDcZCeSs/MtaQOkk/NZziRxK/XISYCNe/Qbx/aEXeQvhm/EGHFhcGGJT/NDPUxCCoz/KtGvWODVVU/tvEL/hOfKDFcrK/SOO/EbLHyhdOR/EGircJdzPx/comEsg/MfWloBhvj/gOCNnagvRz/kIOauipBl/gFqIO/ABdwR/mAvc/KGppQEst/HwZvfiez	TODO
./tnveY/.///../..///lmBT/YBjDnP/yHBtVNWDt/////vxKlAlrRc/./eAnEU/gQkGHpWQ/////CozroRVk/../OUnYg/./zJZou/uBPxA/Vxbi/XybdFA///kkhOVPOG/////ryfuYKbrJx/..///../mSfMIl///jseB/////eDYo/BEaXXRcbS/ZUXbagpnE/iWWm/YwjoA///JxNkVsQ/Ruwilh///./././././../CNMZFOsQJW/GIXXdaRh///YMaeAlNWn/////./////qDBXEVn///SBG/../../pgjiWzrEV///DdJOr///pPm/cGsVSMBdk/ixtKZpVVA/..///../.././yJQJsj/AdouR///RpKCUPdoJ/../YhsdtNWQhL/SZMYhMolE/zAlaO///EHvNTlkQN///wFCzwTz///aipbU/eMhCucTXFc/BVtDlVq/DQvtWfuTh/////./dPpXzjfiZ/./mXc/.///xrgcyunbeI///../crgvUl/YXvAwHVH/../////rRFR/./././//YHv///aKjgY/LdAc/uSgKOci/../mNJMsXCgc/AWp/VPvfuvhDnH//	../lmBT/YBjDnP/yHBtVNWDt/vxKlAlrRc/eAnEU/gQkGHpWQ/OUnYg/zJZou/uBPxA/Vxbi/XybdFA/mSfMIl/jseB/eDYo/BEaXXRcbS/ZUXbagpnE/iWWm/YwjoA/JxNkVsQ/CNMZFOsQJW/GIXXdaRh/YMaeAlNWn/pgjiWzrEV/DdJOr/yJQJsj/AdouR/YhsdtNWQhL/SZMYhMolE/zAlaO/EHvNTlkQN/wFCzwTz/aipbU/eMhCucTXFc/BVtDlVq/DQvtWfuTh/dPpXzjfiZ/mXc/crgvUl/rRFR/YHv/aKjgY/LdAc/mNJMsXCgc/AWp/VPvfuvhDnH	TODO
../VGc///TqqNeCBdMt/EZHeL/../ZBGnVJDVA/beTY/./Mwhd/../SQcpgDe/////bVmlI/gDjeCov/aasnk/faXNYt/sFK/jDjI/././././eoKknoONOk/././//./iSmp/./././bJf/OjN/snYXC/zvclnDE/lWmkaaJQI///.///thl/////oPu/./../pahEJlot/..///ZOeUnkSme///TWt/HkMgz/FqSPW/EpTTdv/zQy/./HlLlUWce/./../../../TBD/./../pDkCDK/ubxQBWnLc/WrwTFMOaN/FrT/ZWZa/xXYk///../jcsYZAyxB/./././ryJgAMyR/wXVFXoDyha/../TlFSrVYOJP///vtMaMJSY/rKZnY/////pLXzGIewTt/dLjWul/Khdp///VUPpE///reSujd///./..///..///./lvleOXX/////joZh/YMfnAv/../ygXS/../ItHyyAa/RQdioM/../cYQtgz/DOsbbPNjT/sypXC/PYFhq/yvQHiPZy/tcTB/.///wFkMmffm/mcSJTRsOrc/..///OaDGxeQvE/tufkzZWOQY/YOzJEr/hdH/../oVWqzL/./../..///XLdB/CJbgQbx/PQMWXho///../XVxweqMxH/wZxIIsj/OkzHVHj/RRzPMHk/xNrEWak///DVCupAWn/OebNoPCk/kCNSHxEyN/./../pUNOCBQS/./sZAEpv/QnCcON///jKeDdv///TdUeii/phSZVI/QdgoKjr/FOyB/SAgEqZAJB/tbVI/NdHGyEprqc///./APuHBH/SnKBuK/uhJAuWXU/DHAwaV/nnYB//	../VGc/TqqNeCBdMt/ZBGnVJDVA/beTY/SQcpgDe/bVmlI/gDjeCov/aasnk/faXNYt/sFK/jDjI/eoKknoONOk/iSmp/bJf/OjN/snYXC/zvclnDE/lWmkaaJQI/thl/ZOeUnkSme/TWt/HkMgz/FqSPW/pDkCDK/ubxQBWnLc/WrwTFMOaN/FrT/ZWZa/jcsYZAyxB/ryJgAMyR/TlFSrVYOJP/vtMaMJSY/rKZnY/pLXzGIewTt/dLjWul/Khdp/lvleOXX/joZh/ItHyyAa/cYQtgz/DOsbbPNjT/sypXC/PYFhq/yvQHiPZy/tcTB/wFkMmffm/OaDGxeQvE/tufkzZWOQY/XLdB/CJbgQbx/XVxweqMxH/wZxIIsj/OkzHVHj/RRzPMHk/xNrEWak/DVCupAWn/OebNoPCk/pUNOCBQS/sZAEpv/QnCcON/jKeDdv/TdUeii/phSZVI/QdgoKjr/FOyB/SAgEqZAJB/tbVI/NdHGyEprqc/APuHBH/SnKBuK/uhJAuWXU/DHAwaV/nnYB	TODO
///././kWKr/lYSr/ajeagZ/aMGnpiFw/.///EoE/.///././GhNesf/IzMlOn///XbMRWKlkkX/./Saq/rVlUKWM/YaTslxg/../XbTIAtWR///lLYcizHF///JaQh/MJD/../aPtmrPxu/bxvBtiS/kmP/sOxE/DQO/.///IbcZW/../iCSac/././KiY///mTs/WpXuxpM/.././//prxc/JylxeslLRh/////vfTZDQviin/pfv/WrH/RJnfQj/../OEsWY///GNOoI/qlwSgQ/./../fGqeSZDcti/KXxgaCNjJX/./DgZlB///jthqgTXi/////CKgXuQYUDE///////CcOjsu/tsaG/UEn/./CPQDfxkVXI/bIJDRaLQOD/../MFsCobSZP/./YQjiv/NFpcLbl/./PBkSsd/..///iIhWCaVKaN///hhAHwr/////lRnP///./../NXYqMP/////./////MecsTMEzS/././//.././WYQEJ///./mlsQz///rcSyM///xXzHc///tlYFsg/uYCApSCQsP/JqTWPkKRBT/./pKYpK/HpYWfo/hachnU/yxYUaVvghb/urBpupuYKE/./..///./VxcpEqc/bgvH/..///././../FbuS/iJS/././//UFxD/././.././//..///ISdHXFCzXz/lqs///ehGImvifgp/KNTBLKqu/bZtd/KjWS/LrgkwCr/HqAhtqaBe/.///FVJqkVy/ExCEZewTF/UmpQQZME/////.././gNNxH/..///SATO/	/kWKr/lYSr/ajeagZ/aMGnpiFw/EoE/GhNesf/IzMlOn/XbMRWKlkkX/Saq/rVlUKWM/XbTIAtWR/lLYcizHF/JaQh/aPtmrPxu/bxvBtiS/kmP/sOxE/DQO/iCSac/KiY/mTs/prxc/JylxeslLRh/vfTZDQviin/pfv/WrH/OEsWY/GNOoI/fGqeSZDcti/KXxgaCNjJX/DgZlB/jthqgTXi/CKgXuQYUDE/CcOjsu/tsaG/UEn/CPQDfxkVXI/MFsCobSZP/YQjiv/NFpcLbl/iIhWCaVKaN/hhAHwr/NXYqMP/WYQEJ/mlsQz/rcSyM/xXzHc/tlYFsg/uYCApSCQsP/JqTWPkKRBT/pKYpK/HpYWfo/hachnU/yxYUaVvghb/FbuS/ISdHXFCzXz/lqs/ehGImvifgp/KNTBLKqu/bZtd/KjWS/LrgkwCr/HqAhtqaBe/FVJqkVy/ExCEZewTF/SATO	TODO
../ektS/../VQxwIpLq/wkjBMtCbh///././BASCxeNL/.///gOMa/./Bfn/../////../UbFZs/..///////..///.///KTf/.///EcvJRzlMvQ/////./LESpxUuty///Tmjgc/szAbjLbvr/gTbvlZ/../../hEar/aDNtWy///pJWvXDcPAW/./rDjuzonqPP/../tVun/.///./NiCvR///./../nRLKJyWQt/./PoCH/dadwmE/yHVwU/owPmnd/hchHhXBmu/PUxn/kPasduOmEr/MvNsufKLDT/./../LwjUfOsb///yKxdgf/WELE/./YDwkkx/BpLr///lFHQzF/./IVXIUzH/XFyQGf/bjIXO/../xmcWDt/../xKvQ/.././gomrMEYGgt/././uUEBAgZGZK/../KyWzFYPorS/CMHMnsb/sNztG///../liPY/./xizvVnbd/./zYkhB/QnzBPvM///zAOTdU/FZQNGJyJ/TJcKNZgYDz/./////.././//////rcOMWuLeG/pfkbimi///JtueacZvp/././ivXOTz///iFMTErfRUR///GKLgqFecky/////../Acwaj/CMr/jNscBDNcvV/UNc/../TCOuXPX///UXZiyceDSN/vzvtKTd///JZNB/GVJbvVmC/./PHuxRkBUMp/../xWQxJNm/RafKAPw/PgDLBW/AHRkaKHpN/.///YeCqhMvpO/JcZAhHDA/.././lbcQtZFv/./wfZ/pkTLG/EvRRtiY/cvAxe/../ShFvwCzX/TZkLZtmd/pOCpW///../FQWzMqHDFF/./qmYE/BwELOlX/nuQuT/./SFGOxWsMa/.///kfmzX/.././//WPeSPhO/wCCipSh	../VQxwIpLq/wkjBMtCbh/KTf/EcvJRzlMvQ/LESpxUuty/Tmjgc/hEar/aDNtWy/pJWvXDcPAW/tVun/nRLKJyWQt/PoCH/dadwmE/yHVwU/owPmnd/hchHhXBmu/PUxn/kPasduOmEr/LwjUfOsb/yKxdgf/WELE/YDwkkx/BpLr/lFHQzF/IVXIUzH/XFyQGf/gomrMEYGgt/KyWzFYPorS/CMHMnsb/liPY/xizvVnbd/zYkhB/QnzBPvM/zAOTdU/FZQNGJyJ/rcOMWuLeG/pfkbimi/JtueacZvp/ivXOTz/iFMTErfRUR/Acwaj/CMr/jNscBDNcvV/TCOuXPX/UXZiyceDSN/vzvtKTd/JZNB/GVJbvVmC/xWQxJNm/RafKAPw/PgDLBW/AHRkaKHpN/YeCqhMvpO/lbcQtZFv/wfZ/pkTLG/EvRRtiY/ShFvwCzX/TZkLZtmd/FQWzMqHDFF/qmYE/BwELOlX/nuQuT/SFGOxWsMa/WPeSPhO/wCCipSh	TODO
