string	set(string)	bool	void
"asseafseaefseefaaffffefafafefe"	["af", "afaa", "ss", "efaa", "sfsss", "eas", "sesae", "ses", "efe", "a", "sfef", "fafse", "aae", "fs", "fea", "easa", "ee", "asef", "fafa", "aaa", "f", "eeaee", "aea", "efs", "eafs", "se", "ase", "easf", "ae", "eaef", "afe", "aass", "ffef", "sesef", "ffea", "ass", "sea", "eeas", "fa", "saf", "sasf", "sa", "eesf", "eee", "aa", "sas", "ff", "sfeff", "fse", "e"]	true	TODO
"ddddddd"	["dd", "dddd"]	false	TODO
"szzohzqh"	["oh", "zqh", "szz", "szzoh"]	true	TODO
"ysddiqvvaipszpisaizvvsiuvsydqsdvpzqvxxpqtaqh"	["vsyhx", "xr", "ux", "vqqhvxvdtt", "piptrylaatpvuvz", "azqhhq", "vv", "ydy", "xvq", "s", "vuvvi", "xpprxpsaszp", "aqrsz", "hazdqx", "ppytyzarpdp", "hyaupxqxzaa", "tzxpsxiqrtsdr", "xztyvsxvzisls", "adydpu", "hyzltilryruzir", "pzthlitirq", "pyxppuqipiq", "vrzthphvzid", "tphvau", "yativutisaaqql", "rplzlx", "xyvtxiiltxxs", "ds", "sxauzdaqlzhvpi", "ilzyshuutuhd", "qryxrxth", "p", "phhhlliuvrttv", "sudlr", "lytqaarqzul", "yupuasldrdxz", "hipu", "dphqsdrth", "vqltzsartdvh", "tlv", "aahvxasrdrrdrq", "yxxhh", "zxulrqdrqyhz", "pyurhztqxzsilr", "iuphhyvayy", "uduiusdrxdv", "ui", "parlp", "lyaruazy", "vliix", "dviluhilipy", "yiqpatrrtusd", "sxsrsp", "sqad", "isrixa", "dv", "yyxuupzlriddxxs", "hypphyt", "tqapirharssvar", "pyuprrzpx", "rlxx", "txtyxxszqdprvzu", "qpurlxrstht", "llrzztthvudx", "duurpuhahrdu", "irlx", "dxhpphxiidqur", "xxpvrz", "ad", "itidlhltdyzu", "iqluhl", "qvivt", "zvaxlqyxiqzyx", "pxua", "urzqa", "z", "rsq", "divraaqayhsqia", "xapvsvvldz", "zd", "ssazvvh", "dddzsxv", "xvpatapyzydsxzp", "lxrxdzturv", "lixtvsxy", "spiarvllip", "vzizydlps", "yip", "qrvdv", "ivulaqq", "zzhaurxy", "iz", "dxsdiutqvaduh", "hqvislpuhuhhylq", "sixypxdrxarptts", "slv", "piqsudqlpqxr", "qrla", "zdrirsuxiivz", "hlhyuryiipdplar", "quqpuxzirdxv", "vsrahzshplp", "ralsxrpdudlv", "uxdrax", "vtip", "lzldpqua", "szavvrdr", "avx", "iqdirllua", "tusxuvzzvy", "dipaxltxaqlhh", "qszyz", "yp", "lpqatqzuialus", "rhdahsrrytiq", "atslqthvz", "ixrvpuuu", "zahvlphap", "sqltxsshpvtir", "zsihazrhsxxz", "pyydlhzar", "aptzidxvyrxvu", "psxurzrxiv", "dhzyuppduhrpr", "pyzhi", "urulrqtlhytqrs", "ytlssrslpd", "rdlt", "yizrqsx", "zlyxq", "tlivqptavhy", "hvthsshpqq", "pzxauqyssuqla", "qdd", "hidydzzzqhr", "uhrldr", "xqrrqzlsudxrrp", "vi", "pyqs", "rhhlzzphth", "xzdxrhrsphy", "h", "lhu", "zuuyvyllldha", "za", "qahdzt", "lyyrpquvs", "taziyilxdplvzyr", "sxis", "rihsrrrtzz", "zuuzyttzshuptq", "yqy", "irahttlyyv", "izrduv", "zdu", "ylrrriatvtqssql", "apxxvapadydvuti", "daplaaqvdlrtvv", "zurthutxvyyylqh", "ppxadhvllr", "izy", "azaitxqpurlv", "xsavzztv", "pvyphlqthvt", "yvtxlxatqd", "xhpzsx", "vqyy", "hstrtrdzpvy", "aqrzzyiadpuryux", "aiszdprqut", "xavszilrv", "dpttrsxzyqqzpqa", "suyappryr", "yddiiuauaqrtiud", "u", "iusqulhldhy", "vrqiu", "hyzpzvytqxzptqh", "rrrhpudhdt", "vysqva", "ussdsptauu", "ax", "t", "zitspxs", "dluh", "xt", "xuptzz", "i", "puzpzdstzxhaxvl", "at", "tupdvzut", "la", "vssitlisstxpri", "lzz", "svhaqx", "qaszlpixuaqt", "yxadqhdsusrqdlh", "ipszpisaizvvsiu", "hdizd", "lpdyi", "y", "zaysxhzva", "xydvu", "iruzqr", "taiuqps", "huvyu", "siqvtqyyxphs", "hyvlqlsu", "yiu", "ushahxprq", "ysddiqvva", "lxsqxsdr", "pvzqhd", "adlhyttsaruxlz", "zvsydzil", "asiaa", "tsa", "xaiqaxslzyp", "q", "ylpx", "sdtsdh", "lyaxtyprx", "v", "ydhp", "vtuvdlilxd", "dvd", "plxdlapzlyq", "utaqyday", "pzzsr", "ivrhtxiqxuztpaa", "ursidhqit", "xxzrzzzy", "lxqpv", "syt", "uuhipztvqxllih", "hqirphytdvai", "hurrllt", "dqhl", "sdxviyvaustayx", "qzdz", "rxyzzlxssvqtsi", "lht", "ldpty", "tppzltrutihzp", "zruvpysq", "xxz", "dvvpqlrzrszvxdq", "ahiavusvhlz", "ssysdusxl", "ylrl", "uryqzdqhsa", "hizt", "vxdrzzhvlapu", "lqihqh", "dpxauhrl", "rq", "piv", "irtuzpsutdpp", "vs", "pphialltrdlzqz", "dsxsrrstxzs", "vlqqhdl", "uxsipaqurhaiisa", "vxx", "auxsiz", "puxvlt", "x", "yutzdd", "ttvqyirtiiqyxpr", "uz", "hqhliqdux", "hzpihuddazqza", "apqh", "tvzu", "dx", "yuvlqhp", "stpar", "xpxdxliqzixi", "taxyaddrzd", "idytxsp", "dh", "alhiyqzruqrt", "thzry", "ihsrurhzqqra", "pvrta", "yplszuxsasa", "pildarvtxrsai", "ydisxrz", "taddphqvzdzxl", "vsydqsd", "xptlsatd", "atrddddx", "ddzhzyhsuyh", "hxt", "suxltarv", "vpzqvxxpqtaqh", "idx", "vyzqdly", "ys", "dhypzvrsilir", "hsdpdaylixa", "llhrt", "luyastpldyvulzu", "rqlitz", "yqshtapilrr", "xtzyi", "uvv", "yl", "hdii", "aqqiittvpuxlzps", "tix", "yushsdhvdapxl", "rizypii", "ixruihlhhtsap", "tilt", "uluuhytszyhlda", "qyh", "l", "zht", "r", "vydvtuquszdhux", "dzvtsaqzlydpvl", "pdzqqtia", "iuivuthlza", "vsyzqqzq", "uxdlqrzzsxva", "yv", "ttyvyataxa", "yvvuzvtadaqpyl", "puuqyipvdiis", "ririrhdavid", "ryuvtxslqhv", "qsrsvrrd", "qxvazltziuihii", "zuu", "raliq", "radu", "ttvryliipxiuhi", "vslddiylll", "ladpxxzxqry", "ziduvxqqsyhduh", "vysvllvrrqpu", "xlqzyussiivs", "xhhx", "duriytlqxvrs", "lyllrsyv", "pr", "tqviavsdhpyuzy", "vddsp", "zqdqu"]	true	TODO
"an"	["a", "n"]	true	TODO
"uovlqevqelijlqcikcjucojxeqdakjgosxijvvosuixjjkjiivxacqjcaeuquslckexqg"	["x", "cquvexd", "slckexqg", "qoudxldsekxk", "ojiduxgedlvsgjijoeidlaci", "vqaidaukjvcjece", "i", "ojxeqdakj", "soikikjglica", "dlcjdevcgxixod", "uovlqevqelijl", "sqaaqkgvodksvjqcekxkjgg", "xceojegokk", "ulqjkd", "lxesgxielcdckqjdjlvkcolai", "egdi", "es", "xoi", "akkskgl", "g", "jdikgixcdsedjali", "sscovaueduqgj", "sdk", "vaslvld", "aldkooxkgkeieocie", "odlkiuuuqgqajs", "uqqcodgvvcxkcv", "uqjicllxvueaaauuol", "axexicsojdsajogiucvqaq", "lxggeiedgqqcqlsv", "xassguijxiaoeqsje", "gdxcq", "agle", "qxvqosl", "lvoxxv", "xdsaxqulxiigokkalkcecs", "uuvcugujoc", "geggsvgsj", "klxdeqaug", "kjdeoijedliixko", "qgucscqxauqloikvouj", "ivxacqj", "lxjgjdle", "ojdixseeqqkacxilokka", "scvjcgvixadidu", "gosjljuiuoeqgdsjjeilgokld", "ckdsijllodjuegeoggcqau", "ucjvxddlequeagcvjgivvjs", "lucjgskdxo", "gsaeeicissk", "vivekjca", "ilecoicssgssexluigcvlvl", "aucqjjqacaxaljd", "kaueuksuoxvlsac", "ujxxksccxudiqgcgo", "asa", "dlgqvaesgqeugovd", "glelvckevlv", "kvaeojeedlciklqiiqi", "igk", "eqojxu", "gqgluluce", "kxjju", "uukkaxlduqlkdgvq", "ssagoujgeaxi", "guaoosqs", "exvsxvckig", "josludeuqsvl", "lauklikioqvkevviucvdxj", "go", "cqixiivxluegoasijaoaiod", "qxsiekuisqlvaeujexcvck", "gcxvusukjcugd", "j", "aiqudjidqk", "eigkiauaagxigj", "aucdgae", "xgduqj", "glvlgsdcljck", "elaqscgdigoxaxivquo", "gosxijvvosuixjjkjicaeuqu", "ueuuqoxvgexeudsuskqovvkqd", "xoqe", "udlajkdvkodugcs", "dcogqqaiaecxx", "k", "jsqigadsxouujqssilvgx", "igijd", "gqxcjclsvekuskovjidgosa", "ulscuixjesludskllxd", "qc", "cjasxacvexdavesiuo", "sogosqaslsaglquivjo", "oijcjuoikogxgj", "uxjkuceoogdklexljkljcusdg", "sexvglxlkqcouxkje", "qovkxojquxxaglcqjjcq", "xxkxaqv", "vodsikiiq", "viixdekslqlde", "glgsqkxdllukgevlsdqiia", "vkil", "cgqgkvugxqcvsgagoevl", "isueeacxgkvkvvvgcqlkci", "eijkaludlciea", "aslujaccqd", "sjaiggvsxddjj", "uugvjucickkixklevxsa", "kclccsdxlgxukdloi", "avaudasjkxs", "dscsqosvovqijxjxckgvd", "jecskxiovjv", "aiaoqdgdiscuaquqojs", "aaakl", "cssadsi", "kkvvvd", "sxvclaxaceddodslvgkdu", "uidksvkglqsjs", "sddoqolldgxuev", "qqo", "ojjaduevsagaqglvqavgvll", "jjlej", "slgvkauuisciidde", "ueqdo", "xdsxjxikckgeuxka", "jxadsggajgax", "u", "kcjuc", "xeisecqoaeedcql", "kgigoguksueqasedla", "jcdkkekjvkdkaviekvde", "aajuddq", "gkacxaul", "lgqqkaoj", "edcugixgsxoaiuxql", "vgsqoo", "lcojiucjksdlgjgggga", "leexxeqkocdlqeill", "jscsug", "vues", "icsasdvs", "ckolekugkvlqkeo", "dcxdueqxicajoluciiodkdi", "usxcuje", "gckoiqkaekasv", "lsckiuqoexs", "jvv", "iidccviakevgqqxsidl", "evujjijejildvvxgga", "ku"]	false	TODO
"isctsdyylg"	["isc", "tsdy", "sdy", "ylg", "isct"]	true	TODO
"kkkkkkkkkkkkkkkkkkkkkkkkkkkkkkkkkkkkkkkkkkkkkkkkkkkkkkkkkkkkkkkkkkkkkkkkkkkkkkkkkkkkkkkkkkkkkkkkkkkkkkkkkkkkkkkkkkkkkkkkkkkkkkkkkkkkkkkkkkkkkkkkkkkkkky"	["kkkkkkkkkk", "kkkk", "kkk", "kkkkk", "kk", "k", "kkkkkkkkk", "kkkkkk", "kkkkkkkk", "kkkkkkk"]	false	TODO
"aaaaaaa"	["aaa", "aaaa"]	true	TODO
"qqqqqqqq"	["qqq", "qq", "qqqq"]	true	TODO
"tt"	["g", "t", "tttt", "ttt"]	true	TODO
"pthmwjqkrhm"	["pthmw", "pt", "pthm", "wjqkrhm"]	true	TODO
"llellloleo"	["oo", "ll", "el", "lo", "ee", "oe", "ol", "le"]	false	TODO
"jjjjjjjjjjjjjjjjjjjjjjjjjjjjjjjjjjjjjjjjjjjjjjjjjjjjjjjjjjjjjjjjjjjjjjjjjjjrjjjjjjjjjjjjjjjjjjjjjjjjjjjjjjjjjjjjjjjjjjjjjjjjjjjjjjjjjjjjjjjjjjjjjjjjjjj"	["jjjjjjjj", "jjjj", "jj", "j", "jjjjjjjjjj", "jjjjj", "jjj", "jjjjjjj", "jjjjjjjjj", "jjjjjj"]	false	TODO
"ftrtwzkcwwcerrwwwwcqqqwqceerecwnecqzrqnenkwrteqkenrqkecze"	["erfrwkzq", "wcqnkkqeqqftfkzwrzn", "knkefrzfzrnkwzcf", "wnrrnrwkttkf", "qrtrckkqtezqezfwwn", "qeezzrnrfefkqeqqq", "wwzcq", "czrfttekkqn", "ftknwntfeffnfw", "wcqzqcwnceqczt", "erzcfzzqqw", "nenqkfzkzfw", "qewzn", "ekkfzttkqzqteeere", "fnkkfecneffnzezqr", "nwzkz", "tneeqfetwkrrrwttzf", "keeqcrzcffqeqk", "kkrktfqetzq", "trtqncrwkwnckkewfwr", "zfcrrwqwk", "kqkctfekrrfzzqnctk", "zentkwtreftqzkfwrc", "ftewqfqnwrwkwz", "wwkwwzqqccfckc", "zqttrwfwrtnwq", "kzqcwztzqfqq", "crzcntrnwc", "wwzetknre", "ercwtzqzfc", "tezkekqzwnnefcrknt", "kecze", "qekwec", "wkwckkcqzzqwfectezw", "qeweqekt", "kntkweeekwwqnrcqec", "rcferqcrtcerkfqcwn", "cewkkw", "nfzzfcwecqre", "ckrrkqntqnrenrk", "kecckktwqqqezq", "wfkttrze", "zrtttfqqzffn", "wktce", "neqwfknwrfwefwtzzzt", "knnec", "ecnfqt", "kfcnnwewqenzeqe", "wfqnqkfrnwnfrqz", "tekkqetfeetczzc", "wnkczqtrffewcrzrnqr", "fczneftkcfcczwrtnqq", "wfcer", "teekkc", "cckwwrwqkf", "czwnweceqzrqffftr", "teekcqecenkrncfkwz", "kqfencwnqef", "qecckte", "wnecqzr", "ctqqrerrzfnqntq", "ktqrwnkzkqq", "etfrnz", "ttnenwwfeftecqnnffk", "ftrtw", "rffewf", "qeknkwtcn", "fweqeqcrqqctneqz", "wrwrkwzfq", "ekefnnfcwzkc", "ccekwt", "nznrtfcwqecrrerqtn", "fttkntwccwzrze", "tknnktkzrzkkqwwffr", "qkcqtettzcncwzz", "kkwekrqzwftezznew", "ewetnktfwwzwfrnnr", "ezczrqkcwnezkwwnrcr", "fnkfkreq", "zkcwwc", "qcrfkqztrncz", "krnctqqwtqnqccfe", "nkwfqtefwwfetcn", "ntczwkwtfececqefc", "kfkkfn", "rqnnztcnnfecqen", "ztzfkfznfqtk", "qztnrfcccntfq", "czzzwrq", "ckrztqkr", "fzwwctfnc", "rknfefcwwcefekwq", "ntzcfkefq", "kfnwz", "ftfer", "kqnzkzfn", "erwqkcn", "ttwttenwecn", "qzceznfewekfrw", "wczzrcfrnzeek", "kzntfrtqrqqttc", "nwentzq", "cwrzfe", "recttercfet", "weqncwcnr", "ktztrecwekercwnzw", "kqqnnewrckzqzefeeq", "rfqkezqeztecfnktq", "frtwtqnf", "cfwzewennft", "fferrf", "wetztzkc", "zkrntnqnfztwq", "ttrqwqewk", "krfcreeetwrrttnftw", "tncnerzeec", "zerrzqfnezzw", "znkftwqzwnce", "qwwfezfkfztcefn", "efttez", "kewzqe", "krwkqwewffrrfzttnnf", "wenfwrrcqfkcq", "wzqztrqtzeqztrwtwz", "rtrtkctqkfcfc", "qfwwkzznkcftzk", "tkctz", "qekcezfknefkcw", "fwkrztkkeqkzn", "weffknezffrqz", "fezkrffckec", "kftfzzwwtzeretkfztw", "eqtqne", "cqfwfwrcnzcn", "tktfqqzkezfczfeqfw", "qzkftzwkwrz", "rteettfftz", "qwrkqftte", "cfwferqtrnttqk", "tzwwkke", "zqwrezctee", "qqqnfeqwkqnctet", "wzrer", "wkekw", "krwekwrqwwr", "ctetrftnw", "ewkeqr", "wncwezcnnrenfwwwc", "rcrztkztnwzwfeek", "krrzf", "cecwrrqkz", "wwtqqtnz", "ererenzrcqkzer", "qwztrwcfqqrtczw", "ftqzrz", "trwentq", "qnktrneecne", "reqrzwkqcz", "zqteekznnzqwkfrzzz", "fczzztner", "rzznqq", "ztnfcfnqe", "zqfcrekzffwk", "tcqrkc", "wcqekrfcnrfkwnzknwe", "rrwzekee", "qcqknekerrfnqwtqwkz", "refrecctqzz", "ckfnw", "nffknqnfcc", "wzczqrwqwtnfk", "ctqrnrzf", "ewrnrqncqeqrewf", "fqfeetk", "zczenqnzzkfttecne", "rzfwwcntqk", "wtwnceefnkktwnrrqn", "qzwrntefneqq", "qnenkwrte", "crnewkzezteeecetk", "ktzkccfqt", "qcwrkrnknqftwz", "tcncf", "qcekr", "qkenrq", "ftfzrkcr", "tffwnqz", "czwtqz", "erqqwwtrwezrcerrtwk", "ftqkwnwffek", "ttekettkr", "nnkwfzcnnwk", "kttfkewczqfnt", "wfwrz", "kecwkzrwe", "rceeqeecfrcknk", "nfrrere", "ettrzqekzcwzz", "tqcqzke", "wwnnqnttr", "wefntrtnckrcf", "cqtwqezcccncwwkqk", "ntkztqrecnrcfetwqkc", "rwnzrrecfckkfz", "kkkrtzfkrfwtftnkc", "kznczffnc", "qtkqrzwrftnfntnefq", "kqtzcrnfqwne", "nzcqetcfrcnf", "nnffrwznnqtfercw", "wekknqn", "ernrw", "fznncnqznwqkcrene", "wzqctnffrwtctqwztnw", "tetkkcfwqrcnfqrwf", "errwwwwcqqqwqceerec", "fcqntnrzfnr", "qnqekncktztfwzqrrt", "nkwtntqeknrckftq", "wzeqwcnker", "nwtzwfwtfencwwk", "eekefqkctqfkfrwnn", "cctqcwtc", "nckrfketffenc", "nrcezzccwecfk", "zeezwn", "qqtzecewnqekqqwe", "tfzzf", "kecnczfkcwezttr", "ewrnzkrqfc", "rzeckketwt", "nctrttnqfqeztzetf", "crfectkqz", "fcfwezwkfrnnffzkt", "fzccekftneqt", "nqzkrzftzzk", "qrfecncwrfzewfnzeq", "zcnrqckectqzftktn", "wctwznczqwkffzn", "fwqtzwefwknnn", "ewwqztnwz", "kfzwfw", "ctzckcreqnwtwqwrnc", "zzcfnwwfnckwckzcqzw", "ceqfc", "ffzcerwzkntwckq", "rwecqzcckknkfnnktk", "qwwefqznt", "wtzertqwkczrctknt", "kcerrecnefre", "eqccq", "nrwfttctwtqkrnzcc", "rtwrferrkt", "tenwqetrkwwznnkwttw", "wnnwewtnrettqn", "wqzfe", "twckqnw", "wzrcqfzn", "krwqkenftfttqcnq", "krnknzfrffrn", "rwnnrzwkt", "zrfew", "wcwfrzcnkeqztrf", "wtreeq", "zzkwntwekfffcf", "qzffte", "ncqfeenqekqtqffc", "frkkcqrnknqncfzcnkf", "rtefekk", "eqfkqn", "tenkzk", "qqctecrtcekt", "ctrwcknfrwtfwqkctwr", "ktfnkzrnrcqrzqcwter", "cnzfwkqerwtrzretcne", "trfczrqtecknfkfwk", "zqfrkerkcenfqe", "rqqeeez", "fzeetrntze", "qckcfzfrcwwqcrzr", "cfecfcncckctzez", "fentzwtezkfceqfwqft", "ftteczztfnw", "nzntrrfr", "ccnzznznnfrqkrekqt", "ztrrqtkez", "eknektftrrzkncnn", "eetkeceftff", "encnqtkwrttcwwq", "weqwwecqkqqeztznr", "cqtcnkn", "eckrwzr", "nkzrnwzzq", "efqwenqercr", "fnkefqkznnnerczfqw", "cnkewqnfcetkerenw", "fecfrcfkr", "zzwfekzrfwfckcn", "tfzffffqcef", "qfqzrfqetqt", "wfffqteqtwtwcer", "tftkqntqkz", "refzfrfeeckkwwqznnk", "cqfnn", "znkqtqrerrfe", "kqewwt", "efnnrfntk", "wqnqnnrzrcrnteqwtw", "znrkktnqekwkfrnqcwz", "wfrwecwekznr", "zrkkzwcznqqrzqncw", "kcneq", "nztrz", "znzznccterzfcccck", "rncccwf", "wwcqwrcenwfkf", "zkfkcftzrekwqkwnq", "cnqkcctzkqqrrft", "twqqckzzfeztct", "tztfzkfckkq", "qrkcktwe", "qtzecf", "trrcfq", "tfffrc", "fctctkwtzqw", "nrzfwzfccwnk", "effwqqcqqw", "zwnkrqrkcecktzne", "rfwtqcwqnnwzzw", "tzren", "rzqrtwrnfc", "kcweqwqeknq", "qfrqnqqnqw", "wnzfkwcwrk", "czezqczrrrk", "qkzrckefkrw", "twnnqcwknzntttk", "rzqztwrweqqnqzkqzqn", "eccnwtkcznqttrffqq", "wwreweecqwwqck", "nrrtwnetcqkccrf", "qzwtknkweft", "eewwktfrfkzkk", "rzckkz", "cnczewnz", "zqrtzctkkzznqwkczt", "tzcrewtttzfncqnqr", "wnfrntfc", "eqknwctqfqcqfwrffc", "etkkqrnfqnqercqqkz"]	true	TODO
"tqqnyqxy"	["tqqny", "qytol", "qxy", "qytm"]	true	TODO
"wwwwwwwwwwwwwwwwwwwwwwwwwwwwwwwwwwwwwwwwwwwwwwwwwwwwwwwwwwwwwwwwwwwwwwwwwwwiwwiwwwwwwwwwwwwwwwwwwwwwwwwwwwwwwwwwwwwwwwwwwwwwwwwwwwwwwwwwwwwwwwwwwwwwwww"	["iw", "wwwwwww", "wwwwww", "wwwwwwwwww", "wwwwwwww", "wwwwwwwww", "ww", "wwwww", "wwww", "www"]	false	TODO
"xkkvs"	["ksxa", "ksxln", "xkkvs"]	true	TODO
"geaayoieoozgsqzkfakrzoiaoeraktfzissofqeerkpiqtraoapzdzoagdrtaitykofyzoyfdetfsdftfssrezkdkffoafykopppaagagzdzpkqesdtzrpadpqtkyirdetkaegrypgqfeyeaortaiifepkspetksyoseoiatpc"	["spgkdrssit", "tzzdyaezpg", "oeqezrqspo", "saztyzfeeoqdpy", "kqkoqdaerqr", "qdaopdfdaz", "sygeosrdfo", "gyysotyadkfaq", "s", "et", "rdeskriardoi", "fka", "aarqddyztgpdk", "kqaraidaqpsq", "riyztppeorfkq", "aipeaagtazgt", "zi", "eosaqtfzrrq", "ayoqtgd", "kdekrtqpsokpqao", "pdo", "fyiqayftro", "sfsggfdffdas", "yqokktodpgezzk", "ikoqzsaqe", "yqafdyk", "yyd", "akaikqaepi", "kzsfsyfso", "tpqoyetiqpeyog", "ekeoqyydifdgt", "ifkorzyotdofs", "saptstqdk", "aoskorzsaqokpry", "efkpfsprdgtoe", "aiazekf", "epdrqd", "aikskfzk", "iqoypifzazpz", "aqrg", "tdqtifkkzszprk", "irtyotdrgqp", "qfdofzddgaza", "eysktgqraosrrt", "zrridgiqr", "pk", "dgdtrtiztyffa", "ppkgosyydr", "krtpiyp", "ayieisppzyqeioe", "gsyqpfsy", "spr", "zprqrktszqgi", "qorgdrrgrk", "igazkgtid", "p", "ksqszfp", "ideytdgkqz", "qkog", "gkaeakpkakyrqzy", "yrgkgpzyokyziqt", "aegzidyze", "qofyfo", "gtpftdittydz", "gkkdqqaroserqd", "aeid", "rdetkaegrypgqfe", "pkrttisgtpkrgid", "rke", "sripartq", "kyotqyarprg", "szfdqgatrs", "dgfggatdqtio", "zkodrki", "ppepgeorkkz", "zzszfzrsffpaods", "ktkqa", "ktofeqketqzoa", "reddkr", "kafipdpqfoda", "fsfkzrpoztsdfea", "ysikorsqsaeeef", "szoqgfdsy", "foqydyp", "fdzffdqdisz", "ayzqqyzigss", "tiearqfd", "gyzzsd", "qfgdfiiq", "sppdage", "tp", "fepayopaydzt", "ypoekoze", "rroqtsf", "oikdkyzafsas", "rpadpqtkyi", "sepp", "yfeez", "orskrt", "ekagqaiyfotsiz", "ftispztrorsg", "pqoopsyyasfty", "qsigqozeoie", "poe", "iteiy", "fzydqqktosyzyp", "kd", "fzo", "siaqopftafigka", "aaykppdoiqr", "dpd", "sfkayattqsitq", "zprkqot", "prstkrqyesy", "qqski", "siszifgqksytz", "ky", "yroipsgagyptstt", "epiodaszqsir", "geiapisfzrais", "kspzizttaprd", "fttsgfreepkqo", "ifsqzs", "aysaddrkdz", "gkaps", "efaodfsesdqzsdk", "fryiqftresp", "yizekisydaetq", "siefr", "kydfifdpkzpa", "sdrtdqya", "yizes", "gzgpad", "tfgqqkqsyq", "oyzqergia", "gkrskroag", "z", "pzztdtgoezdz", "rfq", "izoafr", "ga", "gfsakydqsoyqy", "zgykiqpyizad", "yqqfsppfk", "etrteak", "epk", "dfqkoq", "eyoagtgayetsoof", "atqestszqdsidsi", "fopkkqkssapyk", "aofzdsatdk", "tgze", "pferpepiksirrfe", "ssepkaq", "iftyeeaoadaq", "gzogigapeidfo", "kgekftdprkitfyk", "ofgdep", "fqfdsiotop", "kr", "roqteefdfoaigs", "rrassaatdi", "aagagzdz", "oaio", "zptkreidsr", "atkgrzofazgads", "stifzyspke", "tygopastiqkgf", "eftfqes", "tdrkqqiartfrz", "spepafyqoisqpis", "agkpsierqkok", "oztfgp", "ifyqiotkfoao", "g", "ryeiieyzdk", "kzq", "qddzqas", "foi", "tfssrezkdkf", "sdekpkkqfzaedzy", "roorka", "tykofyzo", "sfqrpikof", "qkrqazgtaryigpp", "tpygdfeyikkrty", "rtigoygzydor", "krtifgzfgzizyo", "tdf", "zz", "rgifstfyikdtqad", "otekd", "adeqgqkazirt", "apqsaizeokotoe", "ketrorfdds", "iyyipdfkrsza", "a", "igegdgekyefs", "ks", "adopegfdzyozaip", "qykqeqpizfrg", "kzigppaopisrkqs", "zzorzgdftetzo", "kqt", "gi", "qtrprtd", "azdsidttrrasdz", "gtepgkdzsedeegs", "fgysfg", "yzeor", "rrto", "fqoipqaiagfosre", "skyeopgkryka", "tdapfegq", "fdysg", "ifyq", "aepfpikiyqzit", "rrttkokstzis", "pror", "rdd", "idiyssseagik", "yt", "qrrdfod", "izqeyspigefi", "qrtirkysfpyzdr", "ftz", "ggoofoq", "rea", "tkqsqoadizeto", "tzqtrt", "fdqqyyszqp", "fdkataotf", "ytaqkotyposq", "aqtqrt", "ip", "saip", "ye", "pqszetttytq", "io", "ktqigraes", "ddifiqpsy", "iyarastyaz", "fqpa", "gpqqazgfzpp", "aeeddftffk", "kzffg", "qagrpgqa", "faerrsao", "pioktp", "itpz", "osskfr", "drkopq", "sizsdkoazsqgzoe", "iayoftzdeedqe", "pfppedzr", "fkgtgyqyf", "dqdaspapseo", "k", "tpzy", "izeyzsayfgrtdi", "rpgkygtfeyzg", "ftgygfdrazk", "zqfsqkkdffkfstq", "pgkto", "getrqiykeqyrttq", "oqztokzofo", "de", "pzdtekeziq", "ygtdfiefkgqqyoz", "kkgtyq", "foafy", "kadezqrgefzys", "o", "efyet", "rtsgososagpde", "fizrdfdk", "yi", "gpkpioi", "gtqi", "zksytadqtk", "tttpfqyqdar", "qeyriaiasg", "ke", "koppp", "krk", "eisd", "paid", "zdzoagdrtai", "dgdpgqkydifrrfz", "ifqtros", "di", "afgzoops", "iazeiqiqrfk", "qytosszaeytyg", "zgqq", "f", "roeeodtapyk", "ytafyqgratkaoy", "proea", "iyrsrre", "idap", "qtodeztddqzpoer", "qsoakpypkpyig", "qrspiyoyzig", "afa", "sqtka", "gsqsftpd", "odikpspaoa", "fzgzifpk", "tzqzpfi", "tkfaggt", "ikeyiseg", "t", "apqeiq", "rapd", "zozfr", "dgrreektzsspki", "qgeadppaq", "kqkoie", "yzzyo", "ygogra", "i", "ikfkeikygtz", "eafgpfseytzketd", "ioztrype", "psgeeoezdzqr", "re", "qeerkpi", "dfit", "ogsyfdayppaai", "kyizfzds", "kygepffo", "dka", "aqafkapyisk", "zaiddpizyq", "efzroefdqtopq", "frdrpeekrdfrt", "gea", "eois", "ae", "aozogpe", "rrdserfkyzytqz", "aqrggafgkff", "yszdoata", "yy", "y", "dfreypyt", "grzqfar", "kedfqyezzeztt", "ia", "teooiffrfegz", "ias", "zetsfd", "dkr", "pysz", "ioipedy", "ieooz", "zyorga", "dfksrte", "ako", "kgkysasoadtrddi", "fzfaqtze", "qpqkdgydg", "trppdap", "kyggpkpoyrt", "rortttpk", "zyrgaipzftesade", "qfptiypiaie", "rdpgztf", "oakytgidartpy", "kg", "goegy", "iffsfqs", "pyqqedttps", "ffasktsetqfzoz", "goayfitffafkafa", "depiaif", "gottyftz", "isty", "fqotzzpedq", "tqesirpf", "qeqtotaysdsyzgr", "kregziftdd", "q", "fodfztf", "dkieepataissd", "dga", "fqsozqrykakog", "kkag", "ooforpedzeyzzs", "asigi", "odtetqyeor", "qtqysafqktrp", "frazpftqzipodpt", "yfeodf", "iktarsprzf", "geaayo", "iyriry", "siyeqa", "yspy", "fgkkpks", "eygeoqoazp", "fkdgztfpagegdi", "ktfzdztsi", "yki", "eotayyapdqqoks", "rrrsa", "fidskfgfftt", "qyfoqdq", "oiaapekoyzq", "fdgtitaqsqiir", "zazidkoe", "trqgqsofgdzssfd", "osyagfykgytio", "qaotk", "yfdetfsdf", "rggkstopzaei", "tzaqsyqigfdky", "tyiktsgoptag", "reydisgiqiok", "op", "gazrzpaykyspft", "eiqtsstedrziry", "gorpyiyszify", "srapsqis", "ftya", "kssoddrzorysoqt", "qriprt", "fkqydtkroeeakea", "fiss", "zfprtqkqaaiqyki", "ypzearqezfr", "krrofkosgoyae", "pqsszityyqk", "gieatskesrgrsqq", "qesdtz", "dazredfisf", "seodyigie", "taizd", "qpiyeoeooyai", "aasspkt", "igkfszego", "deteqyr", "oskstdgiysgp", "qzfrgzfqytsdqs", "kago", "iegaaizaftt", "azfyzeag", "kzpykqiyqzk", "zyf", "reidpaefr", "dofroetrqtgtfq", "zyetkkygoszkzp", "zoqaz", "qzfprrty", "afisgzpoiaa", "aq", "sseaptkgofpd", "sytatizddqfoyy", "dzt", "oezastqrakya", "tfoqttigkoq", "rssefediy", "ekg", "doyqigso", "dzrpdyktot", "qtraoap", "arsgestto", "rkeoysgzyegsgaq", "oqrffi", "oiaoqdgggtdik", "ertfri", "paigzs", "ttskfsrgdzfyqag", "pefsiirf", "oyofsg", "azistt", "fyyiqzypady", "ddispddsiyek", "opkeigd", "tt", "friptgtkoikze", "zfayqkaztezze", "yz", "dzedtroozpis", "zifysodsysezre", "girodqoi", "kkettazs", "fofpastzqtadii", "atsqzpkf", "itqtr", "kayozfypy", "qsogyfqtskkge", "oqs", "iid", "otozzqgzzz", "irqateo", "rekkrkdkszg", "idfkaqtkdry", "pzekokkq", "stegtzygsyeoe", "erqsoyqyapkkoop", "ipttikeaz", "sieqdtsotpy", "igdykaatgkfto", "ttrkzsrgeaqeqpf", "ekktaazfo", "ti", "gqisapqzqd", "oseoiatp", "ppztarsrdeyo", "rgpptaysdoazi", "yty", "zaeorogsytqfgzy", "dsao", "yikdzifir", "roiyqpig", "zdkfpf", "oqyopyyqegzkgpa", "qfzks", "krtkqsr", "tsayrotipef", "yyzk", "spetksy", "tiqgadzsaz", "fafisrtrkiofoye", "oppykpkeaiqz", "dokgykgedsf", "tofqotfeqppy", "agspspyyrs", "akrtkfsreq", "rrqai", "ritqqefkrfrk", "pgf", "pike", "ayerqtsaor", "fqgae", "ezpetkqei", "qzkfakrzoiaoera", "gkkgkdkqspyyo", "qkdakeaidaf", "orsqkqzsgq", "ftekaiqkgpfrfgf", "gs", "eprpyafsdrq", "egpafo", "kqi", "isaprztr", "yot", "zefoe", "pfrg", "aiife", "ittztagogsa", "aefeedyi", "dooo", "drekgqydriope", "saozsieraaky", "qgfzokd", "qtfptpqgtgk", "soqpqeostzqgpf", "osga", "yfogp", "eqizgdaayfsgz", "irfdag", "yzpdsdfrtyo", "osikfiyeqfyeoo", "ikkagoei", "soadqtepgrqsf", "gtdpoapook", "kgyafszsatae", "iioktey", "fadsoftdgp", "tyketrafaq", "rpdfsy", "fqstt", "peatzpssgf", "zkzafstgaifgrd", "yoyagzsfqkeirq", "kzorsyqz", "kiirarsigyg", "fzttetidg", "sfsoz", "oqofgeeddke", "fsqktkkiot", "pqksgrsgfzt", "r", "gpyp", "fgfztdtoapg", "asfyeyktdyriek", "kirrkyfd", "qq", "kdsragipkgp", "qfgprztzsykzoq", "zityisdgogo", "iyy", "zoykrrppqpfkrg", "gatsezdtd", "ey", "gdfaap", "kkddgegsp", "kkdtzeisigt", "sfo", "sqy", "grgpa", "rtskqftzeypkrz", "zzepyq", "qqpprfgay", "ktfzissof", "yqiprtispktpe", "ygeaddy", "qztq", "azgypqy", "pddarrarzrkfqa", "azryy", "aszsr", "seqigz", "pikfzfdfgoa", "rffqzidfs", "zdrqtpzrify", "ikrfgaqrqr", "kgppttd", "dedgkqszsfisr", "spqierq", "kqeapaardsdf", "groiipdg", "yf", "ita", "pkiqtridaee", "tiszrpsa", "ogkfyzqig", "okydrskrdzpty", "pqtyyess", "dy", "qqzqkfoeiyk", "kzfqrykoyrrp", "qqsr", "qqdpk", "fg", "qoifazrs", "eaort", "efeyg", "gpreeddkgf", "zdpptfgpiporegp", "fqepiksokpd", "opaqq", "koaa", "qkkeap", "e", "kgkzd", "adfssyqgi"]	false	TODO
"rrrrrrrr"	["r", "rr", "rrrr"]	true	TODO
"xjwf"	["x", "wf", "xjw", "j"]	true	TODO
"mmmmmmmmmmmmmmmmmmmmmmmmmmmmmmmmmmmmmmmmmmmmmmmmmmmmmmmmmmmmmmmmmmmmmmmmmmmmmmmmmmmmmmmmmmmmmmmmmmmmmmmmmmmmmmmmmmmmmmmmmmmmmmmmmmmmmmmmmmmmmmmmmmmmmmgmg"	["mm", "gm", "m"]	false	TODO
"ssssssssssssssssssssssssssssssssssssssssssssssssssssssssssssssssssssssssssssssssssssssssssssssssssssssssssssssssssssssssssssssssssssssssssssssssssssssr"	["ss", "s", "rs"]	false	TODO
"k"	["k"]	true	TODO
"djhbxym"	["djhbx", "ym", "hbxy", "jhbx", "d"]	true	TODO
"fypahuxoyxfliysaobpvbpvllfcy"	["aiclxvcabcaa", "yxyaaspxvbas", "bpvbpvllfcy", "iffwluvhyfbb", "blslxy", "uspbsihipbhsfs", "aalpyoboiaahp", "ohcvfyvwuox", "xhcyuxwpw", "xf", "uuiofovc", "s", "uoapoalxyoavhfy", "cxh", "pyw", "bx", "slsaasxvbpsuu", "xfhpb", "voysbuiico", "yacoibllcopya", "wxysixapb", "cs", "ylyxwufhvcxwcwi", "yvcxb", "vxxpuawxshpho", "yxalouusuocxfc", "pcoiwhvovbvl", "bpfoh", "soy", "ossiuwpo", "bacf", "syy", "ah", "lbpivxbcyhs", "sasfbcixbh", "pvwsfbcfpubxcow", "lvohupuxbf", "ywaysciuovw", "ha", "hfflcicscbwxbi", "fyhpwib", "cc", "capyxcpbhli", "fbc", "xlubfssiohhciox", "vhxxhvphclhbal", "ucyvluv", "flxvb", "poi", "bsf", "wyvsua", "vicasfsif", "hihyblupvo", "ahsxaalclufa", "cxflpap", "yfhahcf", "cfpwvibba", "iafa", "bhilfphpff", "vhyaxwfcbhyv", "ybvcuobvhsy", "liysao", "fbloxxhivpwa", "ivoyxhlbp", "vxffxov", "aycyup", "oisfpuhvch", "lwavclsosulf", "wpxucbyyyab", "lvoiiv", "ihfcci", "uava", "xlocfowlshooosl", "shcx", "lvfolvwys", "pxbfxiyou", "hvfvhbwcobl", "vshoyw", "liyxcapfbalwhby", "fcxiufc", "hawwvaholb", "xyhpyxuoawib", "whl", "oxiyulfcpl", "xhfaauccwobhysp", "clv", "pahuxoyxf", "bvuxcc", "osowb", "ffluawxs", "uuiibxoiyala", "lipf", "vu", "hsuihiflsa", "sclox", "auhfhs", "hvbhlasu", "xvxowiwf", "hi", "slxuywaibv", "iuvxxpwouh", "yfwayvawayub", "cychpacwosia", "ycyxixyb", "iw", "xxpfavic", "hoapyffyspii", "svbsbc", "fofiscybfiiwbf", "wxpybu", "ssllaiwoawpyco", "slxvpoifhu", "oipoulhiuhchb", "wafshyv", "uhpouoablya", "ao", "avfoysxcuwuph", "aufpvpxciia", "vpxswbyxxc", "cxf", "hhywbwl", "cb", "hcv", "wvuh", "xlccc", "yooxvssucsp", "lvbfi", "flvbicp", "uhcwwhcflopiflw", "axxc", "oiuf", "yofbxlbyu", "uyibohiay", "woylswsu", "woouupivpxfbbu", "yivphicahlih", "ppospcpcaw", "ucfhx", "pubcxybssi", "lvwuhafwyshslaw", "paxwbvufslyyucc", "lfciuavyvuuc", "sxhxlhohy", "ufoywifuffi", "bvylcy", "slhcopbocopwbw", "pxbsv", "cublfasuw", "apvfoafv", "xwwaowxbysluca", "xw", "psioolss", "clvifouyswyso", "suiiuyyxsu", "pu", "slaxufxsuh", "yxlawlowbuyw", "psywhhcihisw", "ufafooya", "fsu", "ubblhbb", "byfcoclwboxv", "ysfphwhh", "pwcppflx", "cxhxucu", "fxhvyuuluxpaxvo", "ubxswawlywu", "wcblcpl", "fcasiwu", "wovwpala", "ilwuyc", "ylcwivoflwhxch", "bbhwuopfvp", "yuwibhuc", "olw", "cpylaol", "lx", "vpab", "ohla", "ipvx", "xhc", "cayp", "oluhfixswaahl", "wfio", "suaiybbvcicuwwp", "fuufvivl", "flxlsb", "hapify", "ulyxwwsyicb", "isc", "w", "lihibyfuxv", "vihciiulpux", "xulswilyxxyy", "cyuh", "bblulxlxloyuwy", "iolp", "svfb", "sol", "vwfwvis", "plpxlfsysppbv", "sivosvy", "wbpfaspihsfb", "lpup", "xscx", "vacbacpsllya", "cyxoiybo", "pls", "yabaxsbo", "yaxhbuvbcp", "lifw", "fblupl", "yblxipb", "vhxwoi", "sluwsawp", "vbiis", "sbochslvowvwfiw", "a", "wawpophllvou", "flculfifhb", "ubicwubivpyhvc", "hiiyhxwpcoasuls", "puxpshucxlal", "usvoohlslaxwil", "hhup", "vuh", "wcbwbcb", "fy", "ac", "iplvwywyhb", "bvollvvflch", "alopxlpaaxwaac", "hxwbxfbcpssc", "yilawvpbaaawlca", "llwfipscyiahl", "iwfwwbylshhu", "abifaywxxh", "lsvac", "lcwbwyfhy", "wvcsb", "yvpfaxfpsc", "ii", "xiuuxyllwufi", "svvussh", "huysvibuvyixpai", "losh", "lispuoyycuowy", "pwioy", "usouvyciuluhxxf", "oiclsbxxhw", "lpsbaplxoxub", "h", "iilxwsil", "ivwuvubuwsya", "bxfuoxsvvhcsyc", "xlcuxbfffvlu", "wicysyupbf", "ahcxowbphblc", "pyualpli", "yowf", "iuaavivofbbopc", "xbsowuixuw", "hlufuf", "bhou", "iciiaywohi", "ppcaxabh", "cofwswo", "ubohwfibcph", "xlapiwvsavpb", "cyy", "buaylssv", "was", "bufipwlllf", "ivbflhohlcf", "sofsvbyblx", "ocsoysoahc", "hbfw", "blalopyffuwi", "ssllv", "vspffhw", "bp", "auccv", "uvh", "yaiocpcwwoyccbu", "avwvifuiihwhp", "ucswlwa", "isooxwbip", "vwbu", "cwapyxxuxpwuuhi", "sifxlsubbxfa", "sflvawu", "o", "hyppxvbsyfccwya", "owxiaoulu", "lspluufulooy", "ccbby", "ba", "asf", "ipuuou", "yowyax", "xxa", "olhbolfsylh", "cub", "ifucoxhbfapysio", "slbui", "hwlbcypsbcsvwa", "vuxwbwbusvh", "c", "fuoxaiybusu", "u", "alfsoubl", "wvubbxuvlxhpcf", "uhvbuppa", "f", "yslcaxvyvwhby", "cwfavafffybcox", "oppsxvvhosiv", "vvloiixbspfvfp", "yicfaa", "vciyfwpu", "hyoowlobiyxxa", "yxsplwvw", "iwxobh", "wf", "phxlxvolbbppuu", "ffsh", "oac", "yxhuwpapsbf", "pfhuvuvpwvcifaf", "bofl", "xlilcffwslhxl", "pxabhuychyypbl", "awpwyfbppfibh", "occufvyo", "sw", "ybocfuplhvf", "lhbycihlhcofuuh", "opwhbulcbviph", "i", "wfslsyacpxo", "yshupixlvw", "wxwpbopvawu", "bhavos", "swfpyxiaiyfhofu", "xsvpvusobhbs", "ploxv", "cbouifcxcaoh", "vlhb", "hpaahluhcy", "lcahiiv", "bccwsfibohaxlh", "ofhxalwbavxs", "uo", "iu", "yyu", "wvuwpbb", "pfc", "uyxawphplsbsp", "y", "yshisulwxwucl", "uulccyfuaos", "sfvibs", "afvayxhoifvupbs", "ahbwvv", "uoufsuvuaoli", "laauuaxyuixipu", "hvsisvoy", "bixfcal", "iyyfpolohbff", "uhbuxyscw", "up", "suxlhsvv", "coipxfyxuppiv", "yaxuypusfvoio", "co", "pfhppobufhx", "lspiwphu", "ahvcuasi", "chvl", "uahxipabc", "vp", "ippol", "pwuflybxxf", "voo", "subxu", "hosucvsohps", "lblpvx", "pcsyw", "xyu", "iooyhsbooi", "xiipyhpovfcaub", "avcwvhxa", "hhawp", "pclcwwl", "iusxvhi", "sixwlapiwvbi", "allxcfval", "yhvfipw", "lhyvwcauspbp", "bvi", "lwpbvivoi", "sohbhwffoawohay", "lwwfiycbuu", "aufxoxy", "v", "cufwhiw", "poychhyaofycflu", "cfabiwliiisa", "ibpcvyyfyvi", "wyfobabcfh", "phlawfy", "xoaffxaihhvvy", "vcfwobuswo", "olbllwollhvf", "wooysifspxywi", "psl", "poisxl", "ou", "yuflw", "xlbyppvhlwwbfw", "hyvo", "px", "xxsfu", "vvclcvcouc", "oliopwvw", "vbloc", "bvwslwuh", "flcssabs", "uoplyuihcluu", "bsl", "ysc", "csvofhosiascif", "safypfcxuc", "hwcvwiwoux", "cpfhhicsxxpplp", "xxisvlwiiha", "vabp", "fiyuay", "puhacac", "ufpihs", "syh", "liafhvxuhhvvfyu", "isupxsicloawuof", "wfyusuxlslpila", "fvou", "sifl", "ppixyyavuiiuiy", "sfwcxcoo", "hobop", "hyaaooiy", "xfowuopbfoluihb", "vbuluchpauvxa", "ifbcbibowaaowbx", "bwsclcvalclcc", "sfsbypxbx", "yochblxvbcvcxcf", "xhufcbchlv", "fvucphcysvib", "pslaibspyvbu", "lyuxs", "awav", "alx", "yfcccc", "bcph", "ofppcxacofoubh", "yvypiuxuloafw", "aoib", "vovoslwcfh", "wv", "xfxhoyblllvysi", "uvyuf", "bvspivhxpbxhxl", "uwwxlssxiblp", "wowbibwsilc", "vs", "vaoufuai", "uiuphhpfyfs", "xpvu", "obcsbixaxxlposb", "au", "swobval", "lwyc", "bywpoffbpcc", "ysfvvufpocwlb", "fofowfhux", "pllwalcy", "pcxaiuayufwuc", "pvchwxhfcavcxl", "uyw", "uwip", "yxlpvv", "lluxixxuw", "il", "pailslfbhwbx", "x", "lavbhyouu", "vabwowwbo", "fhxavbxuiycc", "bcuiwcifaahbvo", "hccuiwbb", "acocwufcp", "asv", "cwfiwyxby", "bwvlwouhb", "woh", "aaboassl", "lyapbbucbopcb", "yfhpxualoffhhh", "vulcalxsv", "luyi", "huyhvcpx", "bifbaxxvs", "pwaxbwlowvfl", "fluvyowsxy", "bpscxssib", "owlua", "pf", "lyswcuwvovlvl", "ciovsxibla", "bcuhxlixpfuy", "csbh", "ywyhphfcvax", "fhhhpvws", "ixsa", "bvapvlopc", "uffxybaycowu", "hiwoalh", "hbvusvblpohx", "iiiuvpwbll", "upay", "xphhibab", "pflpbsbuifp", "hcpywfucbuixcu", "uabu", "iscovxilsubh", "ypyy", "hw", "aphlshfxfsyhbyi", "lo", "psxphvcwuwco", "xwisvvliuu", "vypxvaiupxf", "icohy", "shchaoipff", "ipol", "supxalu", "whpwulailol", "fpuppbbxvfhbcui", "pfpwc", "pysuxvoouxyos", "vasxyvpoayl", "hyhbxvoyuxi", "iuiwpfiolxoa", "iywcxbowyab", "lvailvyhsclhyli", "acufibuloaxxo", "uoisyayica", "us", "xvcvphxssaxs", "lwfbbwfssa", "fuo", "fvhahfshsc", "ppwl", "yafhyuvilpxbwui", "aappip", "bpxxpxxib", "hhaxfli", "b", "cx", "cusassaw", "saapaabpul", "fhlcbvulbvuyxuy", "ubvycspohi", "bapxla", "cccuwlsapbchixx", "yl", "upby", "wsab", "clxvpxccooibf", "bcbpyoyyvohvww", "lyssvswfpow", "ycwcvuycao", "cusauplcffhypu", "axysvpfwawwb", "ppywouwucfya", "asafisyw", "xufihvuobylsp", "lsffolcbiffya", "axaoxapwyh", "uh", "yfa", "xfasaihhb", "axwaluycvy", "lfpvcbcvxl", "vfha", "viwxo", "hfs", "ybpyciwaalay", "souoafwplca", "cufiwfyu", "oiwhluxvhcsayof", "fhybc", "lps", "hlis", "l", "pcuavvyybacliw", "buulfbfsslwyy", "flc", "hbssbcluofy", "xcuvvhvoy", "upx", "bfilwiwc", "hlcw", "ycabiliflhppp", "ypbbvpusphw", "ps", "sipsfiawcplclxh", "olfvchxylfhi", "ofcfx", "lxala", "cuupuiwiscsx", "haxi", "ulovch", "bolvi", "xolvwycf", "lpbw", "opuvvhyaaoho", "pxabvs", "olhxoc", "cllvbxhwfhohopb", "hspxxfwwp", "uvcphoa", "xfulowafvvpio", "oyahloh", "luov", "aoaalxybvf", "vsabaxhwxpyl", "hs", "povys", "yxlyaswfb", "pb", "iiifiyusbbxhyvo", "vlibbucf", "coyubxcv", "ipyvp", "ywwflyxyybpa", "wwysblobp", "xxobow", "pcywouxoo", "pfvi"]	true	TODO
"oodd"	["od", "do"]	false	TODO
"oyooooopppmpyyymymoomymyyoypyyyoppppymoooooomp"	["myyomm", "yym", "oo", "ypmooo", "yo", "omy", "poypymm", "myo", "ompyomp", "mmompom", "ypyyoym", "ppyo", "momooom", "yyymymo", "opm", "oppympm", "oommy", "myyoy", "pmy", "yypmpy", "ppppymo", "myypppy", "ooooo", "m", "poyp", "ympop", "p", "poypyp", "ppmop", "pomp", "op", "mpmopmp", "yymy", "mypm", "y", "oypp", "oy", "pyp", "po", "oypyym", "oypo", "ypmpyom", "ypy", "mp", "yyo", "pyomp", "oppypmo", "oppp", "pmpp", "o"]	true	TODO
"cppgupau"	["puct", "pucme", "cppgu"]	false	TODO
"ysyf"	["sy", "yf"]	false	TODO
"hytyxythyth"	["xyhy", "yxh", "hyty", "th", "hyt"]	false	TODO
"y"	["n"]	false	TODO
"lilkkbkutyqlilkkbkutyqyunpqliinrzebrqit"	["nledveey", "lzybtnliquylr", "iqdntuidqlun", "uvddddvbbn", "ztivdpvpvylp", "ekkdkvyutrinq", "unzbyd", "eruepluztkdpp", "dtyribkey", "yvnt", "tbtlylrdpdiutvqb", "pyzqivpvkzqlzlbb", "eqezbi", "brpbytvrivtd", "ektzklububnep", "vrneliltnpqedvdt", "iilrbpbn", "nnpeirnritelklkr", "vyibbdytiiebkn", "devbeqnunqr", "rzeddltytu", "nkldleblvb", "iylurn", "zldqzvuty", "qvk", "uzqtyzur", "rqit", "ldr", "yzzpdbqrpdiunl", "bderlzkunpylt", "blpk", "bvu", "pkvkyulrdkpqllq", "tkt", "dprp", "ituyt", "tupnzbutzuy", "upkntypldqrqybid", "vtuelz", "dyzvtkvrnibviptv", "bvntndeduvu", "nvzizdvvpvtnn", "dklkupybnydnb", "peiyqr", "vvepunpk", "bvtiunvty", "klyreprdzv", "ueynvil", "ezpn", "qrruqqqlur", "vebqeqqeruzi", "ndvz", "upzlkpuub", "nvrdnlzkvrlep", "zktrrlltukry", "piudbnditrleekve", "qbkqkuvult", "uzeitl", "qrbydebpvy", "dplkvqzbibzedz", "uubyibpqvvdp", "pineyiilq", "uqykltnpn", "kdqb", "blily", "lekvvdbieq", "itquzpiivtzubqiqy", "kldzbiullttitytl", "ziqde", "nltbb", "zuttr", "upilbvk", "elyer", "zlbnttzpdkiepvny", "pqrzpqbbytbrley", "vlleqvplni", "llqlziiib", "rqkiuevkpqqdiu", "vkyqyrnbrtbuzkrlr", "turibrdikkdlnnd", "uzuek", "pyknbkdbk", "rlpkyzdl", "itpp", "yiubqnuleenz", "klrtnuztd", "bbvteulplr", "tbelnztet", "tdkbzrl", "tridrb", "tdpeipt", "rliekkkvpyqeqkrke", "evndueienvzqvyr", "rekrzptiqzpvn", "udivnekbnlkbttiqp", "tpzbllit", "yybzbyknrvi", "zvqevuliuupelvd", "irypvyd", "nluk", "yqubbkvzqkzz", "leklp", "bdpyyiebzzzpl", "zptdiiln", "rkiervepllqeenrrk", "ezyuedniidz", "tkyrlbvvu", "rpqeilvi", "vdrbidki", "ueqiitiypdyqt", "vezu", "ker", "vuuqkvvud", "kbeqepzypeyp", "ervtyuuev", "ikpeilvtktrzkyzk", "qtpbqidbypkydz", "elbpppqynnprl", "elnitkznqkueuby", "nrvdvdlbeybvnz", "nqdrr", "ddytzvllknnluyuqk", "vklnb", "lkbzy", "btqzl", "dbbk", "klueyveqlpv", "pkb", "kuukv", "tdzninyipikptknn", "znvrlkptkiuru", "edkviylzvune", "yevipiebrlenq", "tendnlyp", "veyteu", "uentnpqvridein", "iddzu", "yudukkpnzzeivzz", "dueidvrzrnplkireu", "rkueekn", "rppnvtyitnrdzt", "dnizypnv", "tzkkdllvypezrvqey", "ilvbkkeitky", "vdkdbti", "iurktkvvlplz", "euqv", "qzlp", "irinn", "bzpzpn", "ptlqdinbnuqrnv", "ueqdruytqekppritv", "kve", "drydlpuvnvzyqypku", "rvqleeupuztblk", "ureznzy", "zyeqbtiqlbpr", "tdkpzbntblql", "rdyburn", "lvkidn", "bvddnbtbyuppzbkr", "ezuukkz", "ninvqz", "rvkpbt", "vekpzi", "bqvilv", "kebv", "rqntdkv", "lbivtee", "bbdu", "tuprz", "lqqbzpvplbiyz", "uepurk", "zdtkdvvepeby", "kvrkleqpdbnppttub", "kvbvtdli", "nylkveeuinykdyr", "zzbld", "lyi", "lqb", "puyrrlvdndzikyepv", "lyytpdrunul", "qqkbqtebnte", "itlkvylvllqtuy", "eirikviyqubn", "kuu", "ulinbezydui", "yzurldbptv", "yyqvukvinq", "rlvqybrrpppp", "ulqerbiuvkpbnb", "qtu", "ivdrtlrlne", "yirbye", "zelrivd", "vqyqpbrullnrlee", "nqqyvbkyvktkyby", "vdtrldntt", "ndq", "kvtekknezqr", "pdvrql", "bdtteqy", "lppydplyuzkzietrv", "epkvnrqvvvvzrii", "bkqzyeppv", "rqzytdndltip", "ubblntvinzkqq", "upekkkkvpukr", "iybk", "kulpu", "prpr", "iqlqnrn", "tbzpylul", "nvrekvpz", "plebutr", "lryerddeznkbrnkbr", "nki", "uqzzrln", "lpbkke", "ddzvylldz", "irqvid", "dqitunlltqitddtud", "vzp", "urbbbiudzqrey", "bktud", "lrdrbqpykuvr", "erkeiyek", "dpbeipd", "zbnl", "klulkk", "vvz", "qldqirpurerk", "ilrvqeyblvlntilkr", "nynlvuid", "yeeer", "rddrpiqpqz", "lpytzeytzivpkp", "qdyqlyltuekqbl", "nineiktr", "yzlklyeuittkkqp", "betnqykbziz", "bvkzz", "bdqzbynbuyn", "yldzikvyqqnlbut", "ulydiqkblzvl", "rpbzyuripiinid", "rrqiedtid", "vivlz", "tprd", "rrbbyqtryntek", "rqrtrle", "tzvikdqlktz", "ldvrzdrrktizqd", "dzutyk", "ndb", "rpdi", "kptkenqeku", "tkulkedynqq", "vrkiiry", "bbklztptu", "ruevvylkeqeilkypn", "lvyv", "upebvedtkttrvkup", "kvntlu", "qibnpdnzu", "vznunvqqpqtiknt", "uqnyrypdlv", "qbkqqvdqydlru", "nepzunkr", "rnbrrur", "krpvzkvrt", "ukti", "bbrrzrylyuylqyd", "dkvipydzvn", "ebibybkzen", "ukkzrzvlpipzrk", "nvqbikynt", "ylnvvpbtdzqlzyqbu", "idzlrkdzktyekeiq", "llilvtqqupqzukin", "ydrqyv", "iutnplyyryyend", "uryqutiurtvukp", "udttvvy", "brueuudzieieqk", "npbunbkb", "rdzkiydeknlpdrubk", "lprizvuinzkq", "vbiideir", "pityne", "dvyeduinerddbke", "lilkkbkutyq", "pqulpendrv", "eyrplutkqu", "dprilvlpruuiki", "kyvplqpz", "npve", "kerebdyvtnrikuep", "vviteeepzbnbzqie", "yprvy", "uqtniuzki", "yqiebqtiyyq", "buzdytint", "nirzibedbvriyyvk", "quyylz", "rtp", "ntkyruzvrv", "znykbpzkiiblebn", "puetyb", "kpzukvyyibz", "vzbiniktt", "dydd", "dkrplld", "qppekuuqynp", "lkbritzdydd", "ytlzeknbrbiy", "diqdlneyebykqy", "dpurtbkrplu", "puirikbzyqrv", "dti", "vqi", "etybblqvklkliyq", "urzy", "pbqtnyuztyzkuv", "npuipiknrzvduzzr", "lyenknbitpkyvpe", "ztqe", "qukvqerbddbbytpqt", "ttpyd", "tvlnub", "iqbz", "tilrurzitlnpn", "edbriyqiylenuuqnv", "urqpzikvuz", "yznb", "ikyvqkepld", "uiqllqilqndz", "rvqqznit", "puz", "vvlyzqpdvrk", "pqtpnetnkt", "tnpdlyei", "byvdinriqkqkkv", "pluebtyi", "bkdyukpyrzlnp", "trulqt", "uqznq", "eqtnzneie", "lkyu", "lezdt", "tnrzltruiv", "pqbudpkvbvlq", "utyeibnzv", "utrtqinpbyeudtknb", "rpzpenl", "kuvvvpupzyddulyv", "yrvrb", "tlzlyryrle", "trdeyktpr", "lzr", "vrbp", "rlvlu", "buiquklvtevztntb", "divdpyvekribdqu", "ebvutlz", "kenkebbzvirvu", "nypdbk", "ykn", "yeeqebun", "dttlvyyiqnenry", "eiyubitn", "deiqlqtpizbe", "kqlzt", "pqel", "ilevzibdqtiuzr", "beryzlvzleppq", "qyqueyr", "eereuuqznd", "ennqdqvpuyndi", "duetkr", "ttdt", "iknilvkq", "zqklvdprkkelkzzt", "ltntlyedeziku", "puedipq", "ezvi", "itzvi", "nyqbuqkvt", "lpuuet", "vbeqvrbqd", "enpbkquulyrd", "ryyebutpuddvkqvbr", "pqp", "bpeybqlbvdtuuvbz", "upeqbbe", "rktnplvrvyynqkqbb", "pruiyipntnzkbninb", "luieykeqrt", "ipnizklieekibb", "iqillvkbqlbzee", "qbt", "ripdrqkyudyevu", "ulbedzvvlpen", "eniedulddbkev", "idnpynuqpprlb", "vip", "yvuvidunkeri", "eiudylbzknik", "rzeiqezirkykn", "evinntyrpqblrbezy", "qpyzineqkrrunzb", "yklnp", "vieqkyrnv", "ytbyqpundqirprven", "zipntzetndbtk", "ibui", "dnbdqtv", "tnpnreeruqu", "irppb", "qbpziqnqrzqlbkbe", "uvupdelilyl", "qvuukqbvleytv", "ynpyli", "vktvdlkydetzvup", "pdy", "ndqedzetnn", "bdpuktlzdybqqutd", "pueplkkqivnyerzb", "bnitureyyz", "ptnveudipi", "keukklz", "kuyzeunzukpiylv", "dvllzrpl", "quivep", "uttkpuqzpzk", "yze", "nqqltepk", "dnve", "ueuttt", "lvnvtpvtlzivetlbi", "qktyp", "uyizyekbrbyetdyvd", "tqby", "ipbudvpzeib", "bukkiqeukntzqkz", "idyqbqlib", "lyiypzpdydbdpq", "kyvvpiveknlz", "qvvuezvklenbue", "dyurlbvbuvt", "ynr", "kzzdqvzvtiuevevqi", "rupuzkvziedpel", "dqtyzpvll", "deqtyt", "dldizlzlre", "uurz", "krbt", "kyludu", "bnbrzldrtvlyq", "rbiurv", "trbylvtznvrubbt", "kbpbrnzlepzzly", "ztzqnezrib", "tizeveqp", "lkyndbvk", "uziytbbdvqqdv", "pknkryq", "rrnptlbvbzulni", "lrvikkdbqvuedr", "inkuqbq", "nrlkulqrytnr", "yuetzkddeul", "pllqtqv", "dbl", "bibbuy", "upinuvebi", "rqqetidn", "uikzun", "ktdzdbnn", "nytlndynbkvinbvl", "tirztubqbkzyrrq", "uktqkunriqlt", "dedz", "krzi", "zyyqpneerlp", "dpnbudvlvtyk", "puyekyvduvkvq", "qtpyietnppzzb", "ryluuvrdud", "ryiq", "yly", "tyn", "qrnzineninpqp", "rivkdertiien", "ttnebekkdptpr", "qrnnddyvitntu", "tquiybkbllqzrlln", "pupupuytnnuq", "pdipz", "rkqpyepub", "lkekrdpkqirrdvuy", "nerql", "bupdzepnq", "utlrzeenkkpubvi", "tpiqdiiiydret", "qduukvtzvuqqunip", "kpvptdv", "qnbrpukzkp", "pkivkb", "ppvqkqqqlitq", "yzzeykrbeqqieldye", "qyzdvlduiyvelkdz", "vleblybbbbn", "qpv", "dyznquyblk", "tvuddueqrqkv", "lrdiulbryieukrv", "prnby", "ziy", "tbilqkzzbiiirkn", "enkzlr", "qyrtnyrn", "vbiupbdqdlplzutdl", "bqdeqdbeetbpqeeqt", "kybvplrr", "ubr", "peiptdppzizlvzykp", "qruknuevddrudzr", "tztziqezltuvd", "lvizqnbqpqtqdbuli", "idrzinnerebpvkpu", "piky", "vkp", "blvzeezedzz", "qlqppbppz", "dvvp", "ebbrtklnrkr", "lkzitiludti", "vdy", "yqvzzqkl", "iyenrkddpzvirb", "ereveeill", "evukbtbp", "kdzrpkznrqqvtkk", "rdluvutiyuievubtn", "qrndtdytdez", "zppnuevzv", "tenydykuz", "tkitiptknqdivyeu", "tnlblqpezvzindbk", "bzzu", "liizebvnlperq", "eekuiituzzvin", "vldvbvuyknup", "ibdnbbzvqrdkuyrvn", "knqliqptubyyzene", "kezu", "btqtl", "yunpqliinrzeb", "etlzdv", "vrrpitiunptil", "rturzznrezyp", "yuqt", "nbeqytri", "zdzzz", "epbqdlvkikee", "lbvleyrerpueriev", "qdnireiztbedqiki", "ekn", "yqbquinqrz", "uyzndnkeyblkzyqty", "viznntkulnznqvkin", "iltdvek", "qilzbzttveyi", "nlpqeyevy", "drdtezuklbely", "qurtdepnldktpkqd", "zvteyidtdktqtpyk", "rzkkldduylvnztety", "zkpyqdtiy", "kuueyzdnnk", "vduqkuq", "pytqiy", "tzibeeee", "etiededykeilye", "reubtkttprkubbr", "qir", "pbpdpy", "iiypezknizken", "eylptkqi", "nlvukrryknlrppupr", "rvknurbvidn", "qrtbuedrdb", "ieizlvkzd", "vydunldp", "nelunzutlp", "yzbvnrvi", "ppteybperddtpbry", "dubryiqer", "rpinzbep", "iktdkd", "ezqndlvklryu", "bnqbikly", "qlrlnt", "lnvpide", "bkrrdeirlddzdr", "evbrzyvtblltkpdz", "plnrvyknivtyrei", "zqiuilneviputtryr", "bkzunippk", "eydpvvzb", "evyudnirkvbnyri", "eki", "qtqik", "uezprrykykdzqpel", "tvnynqyberk", "bteir", "elduqrbietp", "idbipntyek", "dnpqybkppbyedd", "yleiektpny", "ybetpqiunndn", "rpbvvq", "evtbt", "uteeupyzlzlppqr", "bqn", "btztbbiqveiiuteq", "zbz", "qqedrblzebzbttrk", "zrtdet", "dednlllbrbqbub", "dkdpqzqeebeb", "ybv", "elzezerieqbtyeed", "yqiqzkdpupuibzvzp", "zvpdvu", "yyld", "btnb", "vnivuynbutpqyplzl", "rbibyluutrti", "pvzbezdvdpzd", "qulyyveepbqyizri", "rquizrquunvyuy", "lpqnrzrqilrzlyv", "bky", "unztdlqeyknzdllb", "revuzkepqpzevllue", "yykdet", "ntqlqpvzkkky"]	true	TODO
"kkqkkk"	["kk", "qk"]	true	TODO
"c"	[]	false	TODO
"xxxxxxx"	["x", "xxxx", "xx"]	true	TODO
"wpny"	["wpn", "ny", "wp"]	true	TODO
"ukvn"	["vn", "ukv", "n"]	true	TODO
"nkkkkkkkkkkkkkkkkkkkkkkkkkkkkkkkkkkkkkkkkkkkkkkkkkkkkkkkkkkkkkkkkkkkkkkkkkkkkkkkkkkkkkkkkkkkkkkkkkkkkkkkkkkkkkkkkkkkkkkkkkkkkkkkkkkkkkkkkkkkkkkkkkkkkkk"	["kkkkkkkkkk", "kkkk", "kkk", "kkkkk", "kk", "k", "kkkkkkkkk", "kkkkkk", "kkkkkkkk", "kkkkkkk"]	false	TODO
"ikkmkappkgxakkivgobqafsoiqkppoifxkipsfqmsmffofpiacsviabqsvsvoisfvccaxrogoriirsmfirxpgrpmfxxpgvbofic"	["ikkmkappkgxakki", "aavbpxmvipbqp", "csviabqsvsvoi", "mqqgaxiokqmc", "voopfvpmfppgcav", "ab", "a", "kifqigm", "sakiqoxoa", "pp", "bssivxgvgorqgoc", "oriirsmfirxp", "iqkpp", "ffmqbpik", "marommx", "koqfvgpcxfibf", "vgobqafso", "mrac", "kvraogxbcf", "gxigsgpxoiqb", "agfpgqmcisqxqxs", "cxp", "sfvccaxro", "bb", "coo", "g", "p", "qoogkc", "pxvrkk", "mfcikaqmorgbibv", "ofic", "grpmfxxpgvb", "ckfi", "kafskrgqqspxv", "gfbicocgfrm", "qbasporivms", "if", "xggikvvfvmr", "xivoricbbiax", "cm", "xioxmax", "fqmsmffofpia", "mm", "gxmisxioog", "vxrsbgxgm", "gpmgiqvfiqiva", "oifxkips", "amvkkomqcp", "skpscabgkcgokc", "ksvbpkss"]	true	TODO
"dmmmommo"	["md", "mm", "om", "dm"]	false	TODO
