string	string
"Hello World!"	"e lHloWrdlo!"	TODO
"slkt"	"lskt"	TODO
"zbxei"	"bzxie"	TODO
"jizilhpyvstjbua"	"ihsujzlpvtbaiyj"	TODO
"qdfj"	"dqfj"	TODO
"zwkpifnryzdhwgoedxucoxryluwfhrwsiptrzkmwopswgvkfdj"	"wfzgxxurpkpvjzkinydwoduorlwhwitzmosgkdprhecyfsrwwf"	TODO
"ulcuenvuoj"	"lnjucevouu"	TODO
"wumzfvxmbrpit"	"uvrwmfxbptzmi"	TODO
"glctvq"	"lqgcvt"	TODO
"gcsmst"	"ctgssm"	TODO
"atzzywvhl"	"twazyvlzh"	TODO
"wkzclgyqbwwjmgyjntekj"	"kgwgtwzlybwmynejcqjjk"	TODO
"umfcg"	"mufgc"	TODO
"xnkxgzcppwpepxktytlldgxkyhfpxgtwzvfslboxzfkrmkuj"	"nzwxtghgvbfkxkgcpppkyldxyfxtzflozkmuxpetlkpwsxrj"	TODO
"qveha"	"vqeah"	TODO
"kpmvzc"	"pckmzv"	TODO
"ltgdo"	"tlgod"	TODO
"rnjhnk"	"nkrjnh"	TODO
"npjytonpjroztqrkqsncckvtyajhjdogirvmakvicevsigfpatjpnyjiqchcygyzi"	"porqskadrkegtycgnjtnjotrqncvyjjoivavcvifajnjqhyyiypzkcthgmisppicz"	TODO
"qqjrhglllxyzxqovhcnromvhcrvdtmtfqzfynncjoimgagktpzpxznyewsftiwbinafypkivrxymszihg"	"qgxqcmrmznigznswakxzqjhllyxohnovcvttqfncomakppzywfibnfpirysigrlzvrhdfyjgtxetiyvmh"	TODO
"vuxtpsvyrqqsmopnzkxwritfxtbkowqljqbvzl"	"usqokitwqlvxpvrqmpzxrtxboqjbztysnwfklv"	TODO
"rioewgznpalgmmpzntukgp"	"igamtprowzplmpnugengzk"	TODO
"rmrvgpvcufpvnszxkczyvztg"	"mpfsczrrgvupnzkzvtvcvxyg"	TODO
"iodzjkcwcvcuprjjgcskcoxkmvhotpbwdczneoqszojoapjpwwomervjttarnv"	"okvrcovpcoopwrtvidjcccpjgscxmhtbdzeqzjajwoevtanzwujkkownsopmjr"	TODO
"szykwecjplyytaeszlfjjnayaghtzoehbbftcgecdysvurwzksek"	"zelalngobgyrssywcpytezfjaahzebfcedsuwkekjysjythtcvzk"	TODO
"oiyewntnghrd"	"inhoywtgrend"	TODO
"fwgmurjjwksetnvarfypcfspofcmzmregwhmpvvqwtejbtjkvgnhpshhbhmrrhakgqlyuyhcmgbxvtscephcxkzltywdbratddiqkasjzairork"	"wrknfffmwvttgshhqygtpkyrdaarfgujwstvrycsoczrghpvwebjvnphbmragluhmbvsehxztwbadiksziokmjeappmemqjkhhrkycxccldtqjr"	TODO
"wybtmm"	"ymwbmt"	TODO
"zztdicyyrhkcnusfdmfzwrlwtmconpscvbavmrtesdqrgtao"	"zchumrmpbrdtztiyrknsdfwltcnsvamtsqgadycfzwocvero"	TODO
"jgsixjmvyoeoejrd"	"gjojjsxmyeerivod"	TODO
"rnpqucaatsnbcqchgcrezuor"	"ncsqcurpuatnccgrzoqabher"	TODO
"prhsqmujggpmfrtnwsxpxrmsoogkkzjldqhsfooozmftkwwcfnssplznzcdd"	"rmgrsrozqomwnlcphqugpftwxxmogkjdhfozfkwfspzzdsjmnpsklsotcsnd"	TODO
"xuepvitlapuajtywrzfqghhbbqtumfvupczehtooglszbwboiebrygaqyjabzqvjnrebqwbkmkrmxzuypnbhuc"	"uiptzhqfctlwegjqrwkzncxevtaujyrfghbtmvpzhogsbbibyayazvneqbmrxupbuplawqbuueozorqbjbkmyh"	TODO
"wtujijy"	"tjwuiyj"	TODO
"pauasicptynsblchhgcodfyxehiwiyihqyofaxjarguqkxyaoqhmauxptufpmihdytkohilgqevbsrgsofhxdyqxaavazqtwojzyluieaydeloutqflodvqjpb"	"aiylgfhyyxgxquuitierfyaqjuyofvbpusctnbchcdyeiiiqoajrukyohaxtfmhykhlqvsgohdqavztozliadluqldqpapshoxwhfaqamppdogbsxxawyeetoj"	TODO
"nrtuauvmucaxuimygydltjvcbisknypuselfqtlttgyt"	"ruciyjiyetgntavuaumgdtvbsnpslqltyumxylckuftt"	TODO
"zmaimnvvgufaxpoynwyudcmbqtnzpysrkdhnbqwnlbz"	"mnupwctydqbzamvgfxonydmqnpskhbwlzivayubzrnn"	TODO
"amtobmdbeiuuelwuviztkvmh"	"mmilivatbdeuewvzkmobuuth"	TODO
"jsjokxzpkjquirfltxeopfjdgiaogesxuykfwesgokrnxa"	"sxjrxfieyekajjkzkqiftepjgagsukwsorxopulodoxfgn"	TODO
"vafmutbisjxsgtr"	"atjtvfubsxgrmis"	TODO
"gnl"	"ngl"	TODO
"toibnijowsidou"	"oisutinjwiobod"	TODO
"vqosmbhqvuxsfhl"	"qbuhvomhvxflsqs"	TODO
"bojfocpeytyuxwc"	"octwbjopyyxcfeu"	TODO
"oyouznonw"	"ynoozowun"	TODO
"mufwbemzbsguevmspeyzyhempaguqkediikbpzzlyigfalwthoalabzllffvbxysdgk"	"uesvehakizilobfxgmfbmbgempyyepgqeikpzygawhaazlfbydkwzuszmudblftllvs"	TODO
"evornmxgwovytcgjfljic"	"vmocleonxwvtgfjcrgyji"	TODO
"fhimttravcpkp"	"htcfitrvppmak"	TODO
"kcnoosyyiakwnseatnxzkndgsrnaaenxpjrxrmsvqofsuyrcwmyeycrflzoqeorvhvfoufgxwcyjloohxrdnh"	"csasnnrejmoymczovfcorknoyiknetxkdsnanprrsqfurwyyrloerhfugwyloxdhoywazgaxxvscefqvoxjhn"	TODO
"iectcethtdwditktnoiwqzjomolxiruvrtiufpmhvfimwfgkey"	"eedtozortpffyiccttwikniqjmliurifmviwgethdtwoxvuhmk"	TODO
"xvtfjee"	"vextjef"	TODO
"rjjjixi"	"jxrjiij"	TODO
"ldpqwj"	"djlpwq"	TODO
"ocforamaxrrymxicetgkugbfnevktwtqibvjrkfxnmmfzxpmfftqxlzsnjbukyzflvzf"	"carxtgewbkmxfljyvofrmxrmiegubnvttivrfnmzpftxznbkzlzoayckfkqjxfmqsuff"	TODO
"irpljwi"	"rwipjil"	TODO
"xqdtqtpoozvtwwupiwbcnewrecfszgx"	"qtzwwecgxdqpovwuibnwefzxtotpcrs"	TODO
"ezgkdhvprmtoruhxshrjbww"	"zhmuhwegdvrtrhsrbwkpoxj"	TODO
"zehtoqlvyoqvywwioifbb"	"eqowizholyqywofbtvvib"	TODO
"mrzeya"	"ramzye"	TODO
"segiytzi"	"etsgyzii"	TODO
"jrzvw"	"rjzwv"	TODO
"psfzpxoghrin"	"sxrpfpohizgn"	TODO
"qfx"	"fqx"	TODO
"ilmgjjdaqpfqlu"	"ljpuimjdqflgaq"	TODO
"mmwwpuoryqdseggzmdkprsglyfxmqhbzobkbhcabptzqwfsgohclzwevbqabpriaiyavtnmvcsiklvmtsrijopqrzmhybyoukywjqaky"	"muqgdsfhbctfhwqrynsvrpmyyamwpoydegmkrgyxqbokhapzwsoczebapiiatmcilmsioqzhbokwqkwrszplmzbbqglvbavvktjryujy"	TODO
"bhsqnyqmbnmrdmoitehrjjjerrnibhpdimy"	"hynmejrhmbsnqbmdothjjrnbpiyqmrireid"	TODO
"kchphoc"	"cokhhcp"	TODO
"afiznouktnrnnpwdzfmvaaqhmibdy"	"fonpfaiainutrnwzmaqmbyzkndvhd"	TODO
"yleoawyhgzttcryvknougbylfzxpqkh"	"lwzrnbzkyeaygtcykogyfxqhohtvulp"	TODO
"zazocdfst"	"adzzcftos"	TODO
"rjawzzmx"	"jzrazmwx"	TODO
"rofa"	"orfa"	TODO
"raesycrfnyuwlxg"	"acyxreyrnulgsfw"	TODO
"ninj"	"innj"	TODO
"dlznyloxrk"	"llkdzyornx"	TODO
"upfippwrioregshemvu"	"pposvufpwirghmuiree"	TODO
"woprfnmdknav"	"onnwpfmkardv"	TODO
"zgyv"	"gzyv"	TODO
"sjijoyuefadx"	"jyasioufdjex"	TODO
"aixuoojtfjzhxrhwdqkpbxudtctjrtmkorco"	"iojrqxctraxojfzxhdkbuttrmocuthwpdjko"	TODO
"sydjghiruktnwucjoyexmftuzcnyczzregfqcmacjqxirfkmbydvil"	"yhkuyfczgmqfylsdgiutwcoemtznczefcajxrkbdijrnjxuyrqcimv"	TODO
"wtu"	"twu"	TODO
"unatxotvlipuinjubqsrudkcrphwzwcwbzvcgqawkp"	"noinqdpwzqpuaxtlpijbsukrhzcbvgaktvuurcwwcw"	TODO
"wnguppwjn"	"npwgpwnuj"	TODO
"lzljlugrcdhcwg"	"zudglllgchwjrc"	TODO
"nkfphvtupycyxnxnsrtfdqlpjqxhvdavcidmwxxbwkqzasukreayplyocwtrakumbjcuzjiqeykflz"	"kvynrqqdixkselwkjjyznfhtpcxxstdljxvacdwxwqaurapyctaubczieklpuynfphvmbzkyormuqf"	TODO
"jrwh"	"rjwh"	TODO
"hkjmackjced"	"kcehjakcdmj"	TODO
"oodv"	"oodv"	TODO
"yrwgbevumrzdap"	"rerpywbvmzagud"	TODO
"molkgexmgb"	"oebmlgxgkm"	TODO
"rbambi"	"birabm"	TODO
"jazkmqhnyagbfvivpnzhwykyfvqftjfo"	"aqavnyvjjzmhygfipzwkfqtfknbvhyfo"	TODO
"gxhruryykdrjkqypisxnzddiysln"	"xrdqsdsghuykrkyixzdylryjpnin"	TODO
"wbrfwfyymsoncnshvportgtuyjkcdgbxyfzxypmcdzkxxopcjunuwuhlamgbukzrctaxnovqnvzqpvjirzza"	"bfsnpgjgfpzouumktovvzwrwymocsvottykdbyzymdkxpjnwhaguzcanvnzpjrzfynhrucxxcxculbrxqqia"	TODO
"edupzdpwdm"	"ddmeuzpdpw"	TODO
"cygma"	"ycgam"	TODO
"uufplnxpho"	"unouflxhpp"	TODO
"lazaqvkbpslxzsvnumguwsauaejbxg"	"avssmseglzqkplzvugwaajxabxnuub"	TODO
"awvmjsboe"	"wsavjbemo"	TODO
"toxueut"	"outxetu"	TODO
"frm"	"rfm"	TODO
"fjrthokhbna"	"jonfrhkbath"	TODO
"sdwshbqgtmwvctnpefiyfdquf"	"dbmtfdswhqtwcneifqfsgvpyu"	TODO
"rjikxmextephox"	"jmexrixetpokxh"	TODO
"eqyp"	"qeyp"	TODO
"jcgwdsir"	"csjgdiwr"	TODO
"oldrzlgwfdecgvvubnliykgv"	"lldvnkodzgfegvblygrwcuiv"	TODO
"uwmlumbqvhomfvifndn"	"wmhvdumubvofinnlqmf"	TODO
"migzhudrrvi"	"iuvmghdrizr"	TODO
"kvtcvd"	"vdktvc"	TODO
"bzybzz"	"zzbyzb"	TODO
"hpvtfasmuxseqhzctjbsakruethznudjrzruxcxrnb"	"paxhjktuzcbhvfsusqztbarehndrrxxntmecsuzjur"	TODO
"upwldyb"	"pyuwdbl"	TODO
"xrtsuysybmgnrebvzkvulysikldtpoc"	"rymekyloxtusbgrbzvlskdpcsynvuit"	TODO
"dajkvzjplqoacbxvazmkwrkyuxosbtwvgmiwigd"	"azqbzrxtmgdjvjlocxamwkuobwgiidkpavkysvw"	TODO
"xzfhzjqglrqywktoojmhscqxxmkzifn"	"zjrkjcmfxfzqlqwtomsqxkinhgyohxz"	TODO
"unvzkyk"	"nyuvkkz"	TODO
"btkxzr"	"trbkzx"	TODO
"giltykzykiuntshplpibpdmbvdgfgxlcsmlecjwtyisrfzujaixhslmetijrwzayxiueoctvyzvfpndenvyjvjpiarwzksndewewmv"	"ikispddxmjizilizicznvjrswvglyzkuthlipmvgglslcwysfuaxsmtjwaxuotyvpdnyvpawkneemtynpbbfcetrjheryevfejizdw"	TODO
"fbuapcdy"	"bcfupday"	TODO
"yhgruagtbbiipgdhwpflpahdevbvzjiwedulnljsvgzvmqdwqfqkyypqkxdnupzeguskyuzlnaanfkkuskzmsvbuanhydfdc"	"habgpavjdlgqfyxpuuakkvnfygugbipdwfphebzieunjvzmdqqypkduzgsyznafkszsbahddrtihldvwlsvwkqneklnumuyc"	TODO
"xdwcngomdmwudbypfux"	"dgmbuxwnodwdyfxcmup"	TODO
"pvcu"	"vpcu"	TODO
"uperzdygzuu"	"pduuezyzurg"	TODO
"wfwtbzaygveviwdlhveztdqarhonwaqxcyzvfctquzbnkhfprmkojiocgxv"	"fzvwvdhayczhmixwwbageidhetqrowqczftubkfrkjogvtyvlzanxvqnpoc"	TODO
"jqhg"	"qjhg"	TODO
"tdovffnnvookdfvxufzhfrvyvxg"	"dfoffrxtofnvodvuzfvvgvnkxhy"	TODO
"rmgdhcvafucbhgt"	"mcugrghvfchtdab"	TODO
"xsk"	"sxk"	TODO
"fup"	"ufp"	TODO
"maa"	"ama"	TODO
"gunmuuc"	"uugnucm"	TODO
"xotphvfdjgll"	"ovgxthfjlpdl"	TODO
"whgsllgypmnunagifxdbgfpqdqrdyduexythqxqnbgjiggxm"	"hlmaxfqdyxggwglgpnngfdgpdryuxtqqbjgxsyuibqdehnim"	TODO
"jutqpgzeeztngc"	"ugzcjtpzetgqen"	TODO
"upvzoqdbgx"	"pqxuvodgzb"	TODO
"fddynexckddd"	"dedfdnxkdycd"	TODO
"tikgvmrhylfonzjeiecvnjmkbkzdqlerab"	"imlzejklbtkvryfnjicnmbzqeaghoevkdr"	TODO
"tuh"	"uth"	TODO
"eaehspo"	"apeesoh"	TODO
"kbgxhgnfvsall"	"bgskghnvalxfl"	TODO
"rdxns"	"drxsn"	TODO
"aohihob"	"ooahhbi"	TODO
"tnfpupavb"	"nptfuabpv"	TODO
"jrcbghjjuepuubtrhvgkjbvxxd"	"rhebvbdjcgjuputhgjvxbjurkx"	TODO
"yvcekmins"	"vmyckisen"	TODO
"rxqqxotohvdgbnvmefsforuszukr"	"xovnfrurqxthdbvesouzkqogmfsr"	TODO
"gtkequbqwduhruntpknuhkkedtvkbzucvukmzfgwlmvnxyrlyaad"	"tudukktzufmyagkqbwurnpnhkdvbuvkzglvxryaeqhtuekcmwnld"	TODO
"alinekoihgimjgbzwihbissmxbqpdsqrnytjetcttcjztatqatgpjnpaxzxozufwlldcrekrissfvqufvakyparqmyqqlmafjpwrgtdnyvfdfbxneajcdrkebbrhlt"	"lkggisbsytcatnzulesqaaymptvbarbtaieohijbwhisxqdqntectjttagjpxxzfldrkisvuvkprmqlajwgdyffxejdkbrlnimzbmprjtzqpaowcrffyqqfrndnceh"	TODO
"lxberdnsxhwufsdwbsvjziuydrcqcc"	"xdhssirclbrnxwfdbvzudccesuwjyq"	TODO
"cwptljakugylgjltytimqfitulzwhvozhvoazr"	"wjgjtflvvrcplauyglyiqiuzhohoztkltmtwza"	TODO
"dldhwftdzfghzmqm"	"lffmddwtzgzqhdhm"	TODO
"glszpxfjnpjl"	"lxpgspfnjzjl"	TODO
"bgflbzgclphywedjqmepzsrklxpniyiyhdwedymdxpccfvhwnrnmdppqbbdxnlbgijkdiotnrleiaqxwc"	"gzpemsxydypvrpbljolqbfbglhwdqezrlpiihwdmxcfhnndpbdnbikitreaxclcyjpknyedcwmqxgdniw"	TODO
"nvfohq"	"vqnfho"	TODO
"zxoq"	"xzoq"	TODO
"ipvhjodasermbmoscqsszcupf"	"poemqcivjdsrbocszufhamssp"	TODO
"pgexhoisqvlewdypmfsbvx"	"govdfxpehiqlwymsvxsepb"	TODO
"wtwrnulinepnhgonprxjesrandpnxhhmylzvptbbwvwpuacfc"	"tuegrsdhltvawwnlnphopxernpxhyzpbwwuccrinnjanmvbpf"	TODO
"atqsadi"	"tdaqais"	TODO
"elriolmlclpjwlkftqfrtyxryjafjxydezlmjltswkyeifqdbcibzmhtamjmbzwtwfujjnrwbbswdbcr"	"llllqyjxzlkfcmmzfnbberomcpwktftxyajyeljtwyiqbizhajbwwujrbsdciljfrrfdmsedbtmtjwwr"	TODO
"zkuugxs"	"kxzugsu"	TODO
"hvjeotklwownkxznmqmm"	"vtoxqhjokwwkzmmelnnm"	TODO
"idvzbekffvxlcjfaaypirhuspvisvkkjblqfktsvefxdigcjmiegof"	"devjyhvkltfgifivbkfxcfaprupivkbqksexicmeozflaissjfvdjg"	TODO
"rdtfrvspzgrmebpzgwemxualfow"	"dvgbwuortrszrepgexafwfpmzml"	TODO
"hbiqlfcjsovipolalvbctmbwpu"	"bfoovmuhilcsvpllbtbpqjiacw"	TODO
"puwqoynibpxucjyxpeahsybggmfntfzllslsmmayorikxlskadmaaqvvdmvsgbxyspcqpbkqyoxmxuoxnaousecgkwkibvlifyhirrzfnjdsobdbpmlv"	"uypjeymfsmrldqmbpbouaewvyrjbmpwonbxcypasbgftzllmaoixsamavdvgxscpkyxxonosckkblfhrzndodplqiuxhgnlsykkavsyqqmxugiiifsbv"	TODO
"nivjayrkoycvon"	"iyynnvarocojkv"	TODO
"xtccsctslcpjlgrouggqdysnnlrc"	"tccggylxcstlplrugdsnrcsjoqnc"	TODO
"uujzi"	"uujiz"	TODO
"biwyfn"	"inbwfy"	TODO
"frfiqdyuhybeihkmczyccaxlbxwjbhhomnxbrgbaohgrkmifaaclglwjkekzsrgbvemqnjejokwrutbctgzjmoliboarrxddhhfimzlfufwznx"	"rdyhzaxhnghmalerejktgooxhzfxffqyhbikcycxbwbhmxrbogkiacgwkksgvmneowubtzmlbardhfmluwniuemcljobarfljzbqjrcjirdifz"	TODO
"clufbxynqycucjcfhluovvmxrh"	"lxyjlvhcubyqccchuvmrfnufox"	TODO
"obpigflzpnrkhw"	"bfnwopglprhizk"	TODO
"pikhqpq"	"ippkqqh"	TODO
"hsgakrjcjtmpbnwlnvxwqzcfnjjfnizcsfxafmxvlqoccovskvhbdwsfuvxpkdulgrdxgzmjbspkhfavoecvuwndrfkuq"	"srtnvzjifmqovwvdrzsfewfhgkjjmbwnxqcnjnzsxfxlocvkhdsuxkugdgmbphaocunrkqacplwffcavcsbfplxjkvvdu"	TODO
"codxceummasyvkxcopmjohevjhgmwprhkgrlsxjonocatzbcbtl"	"oeakphhpgxoztcdcumsvxomoejgwrkrsjnctbblxmycjvmhloac"	TODO
"fqonjkcnrctxxsfshxnrkjfyqkpvtepgjszgibrzasxvzqnioljsudkwbnciffpnnmnbfzyxlgdmzaavkuz"	"qkcsxjkesbsqldnfmzgaufojcrtxfhnkfqptpjziraxznojukbcfpnnfyldzakznnxsryvggzviswinbxmv"	TODO
"wqfgjfyukpjyharrhgiboiwyjhvwhreheuvvngoovuznwnyeycelmotftrlfwbedfyidbokamebrzehudykognxbfkwqkvslrtdckdmtwnynewmxkciozegilhl"	"qfpagihruguncorbyoeeynkvtdnwcehwfjykjhrhiowjvheevnovzwyyemttlwefibkmbzhdkgxfwksrdkmwyemkizgllguyrbywhvonelffddaruobqlctnxoi"	TODO
"vdmcboe"	"dovmbec"	TODO
"eulrilosfozxpok"	"ulooeliofzpkrsx"	TODO
"ynvekmmrftnjmftmistzhdeqstc"	"nmtfsdtyvkmfnmtithescerjmzq"	TODO
"fjbilztcbfkknnxlclrrsbjdoyrwkqwyqd"	"jzfnlbyqdfbltbknxcrsjorkwqicklrdwy"	TODO
"ltgwqlnwbquebcgonfqgymod"	"tlqcfmlgqnbubgnqyowweogd"	TODO
"mbrvhithfoqsnjarueubjvnbgdvplprmmgsmkn"	"biojevdpgnmrhtfqnauujngvlrmskvhsrbbpmm"	TODO
"suwp"	"uswp"	TODO
"yxzhziqlfwcwrhjbykkoeryvbqvojsu"	"xiwhkrqsyzzqfcrjykeybvjuhlwbovo"	TODO
"yerkjrzy"	"eryrjzky"	TODO
"zzjmcunhcikihfzwdbiiicjcdqlkrcwsmowegcqywwymivyozbjviwbbkjoucibcibnaivmnybpicynfmheplooenupejv"	"zuifbcqcocwvbwjibvbyhouvzjcnckhzdiijdlrwmwgqwyiyzjibkocbinimypcnmelonpjmhiwickseymovbucanifpee"	TODO
"fsmoenrxxbswmalsjxfgvijlzhfzoawcomupslhthduuqzfymiubxfvunfjrdhghdzbeiufkidydsigwzsjngexkyyvbwvinilmqzwpmfjcprchthkzsyv"	"snbaxihamldziffhzudiseyvlwjckvfmerxsmljfvjzfowoushhuqfmuxvnjdgdbifiysgzjgxyvwiimzpfcrhhzyoxwsglzcptuyburhekdwnkbnqmpts"	TODO
"xda"	"dxa"	TODO
"ssmszjlnrimrgh"	"sjihsmzlrmgsnr"	TODO
"ysorb"	"syobr"	TODO
"fmysyruhhzcrznbcoimdvcxuscavenqqowsozmxomylwnbwbvgzwhhvqjdmzcbdmvwxqnjlozxmmtazvqzceygfnogqnyusxrjlqx"	"mrzniccnwmybghdbwjxazggujfyyuhczbomvxsaeqoszxmlnwvzhvjmcdvxnlzmtzqcyfoqysrlxshrcduvqoowbwqzmqomvennxq"	TODO
"kpshqvpanxrxpldcc"	"pvxlksqpnrpdchaxc"	TODO
"bpnbirkyhchjzfq"	"prcfbnikhhzqbyj"	TODO
"rxanuprteknadzjmekbhxcgxlixmloejcqgpqptcm"	"xpkzkcioqpraurendjebxglxlecgqtmntamhxmjpc"	TODO
"ibbhyqikaoajd"	"bqoibyiaadhkj"	TODO
"onnmobtsljrkbzufnmescrgexxaqmrditkbbbimrvflillautpawsynejvpxqlnsspgfowaotundgmgotzuuqnxodhsywwrjexig"	"nbjzmrxrkiflpyvlpwumznhwxonotlrbunecgxamdtbbmvllatasnjpqnsgoatnggtuqxdswreimskfseqibriuwexsfodouoyjg"	TODO
"hnntbbonencwgcnqgv"	"nbncvhnboecgngtnwq"	TODO
"bkylkgxmqbjjo"	"kgbbykxqjolmj"	TODO
"nywffuvhtsaudqxkmgtnfopgknekanwkpnmrydmdmhltsnangvtkdciifptmofzbtflvkloq"	"yusqgonnndhnvcpfflnwfvtadxmtfpkeawpmymmlsagtdiftoztlkofhukngkkrdtnkimbvq"	TODO
"bhmpw"	"hbmwp"	TODO
"bwuccnuk"	"wnbucuck"	TODO
"uqcjdsnlepunksgauvlrsbxkrnmcxoadhpmutaggefk"	"qspsvbnopafucdneukgulsxrmxahmtgekjlnarkcdug"	TODO
"pbsndhmseselips"	"bhsppsdmeeisnsl"	TODO
"byexcohhqjqfcyhjgvgspgqchhczmpzlqifz"	"yojyvghpibechqqchggpqhcmzqfxhfjsczlz"	TODO
"xzymkeboflkzwlexpequ"	"zellexykbfkwepqmozxu"	TODO
"qrpdnciqehhcifneuxzjmopfwcfzdzwbzbtu"	"rchfxoczbqpniehinuzmpwfdwztdqcejfzbu"	TODO
"mryfijsewhxwotb"	"rjhtmyiswxobfew"	TODO
"pbatuwt"	"bwpautt"	TODO
"mpgqbldjauuonfrlrgrvkheqcse"	"plufghsmgbdaunrrrkeceqjolvq"	TODO
"paknqfpwygrhkuqmsrglyosgtfwelw"	"afgurofwpkqpyrkqsgystwlnwhmlge"	TODO
"vvus"	"vvus"	TODO
"fjgbpbdszzgc"	"jbzfgpdzgbsc"	TODO
"psurbbljftsjwxjgtmbwsttnlignkdnewvcjwehbvsrgtgxtrrs"	"sbtxmtidvesgrpublfswjtbstlgknwcwhvrtxrsrjjgwnnejbgt"	TODO
"elxrugoqbnw"	"lgnexuobwrq"	TODO
"idp"	"dip"	TODO
"smwumxtujvemsvuqcawais"	"mxvvasswmtjesucwiuumqa"	TODO
"kzilg"	"zkigl"	TODO
"lpukganhuqeydlhaudujqvajarcqsggbsodjtymluhiqvgqolevujemyhjkjwfyodntmdiwybnhqkhduisgjygoepubsmibppmvrpepogbxzthtg"	"paqldvrgoyhgeejfninhsguimebhlugnuedhuuqaacsgsdtmuivqlvjmhkwydtdwbhkdigyopbmbpvppgxttkhyajjqbjlqouyjomyqujesprozg"	TODO
"tignvpkvyyqngmczzdzx"	"ipymdtgvkyqgczznvnzx"	TODO
"vxve"	"xvve"	TODO
"altxjjspfgoxsyyscdvpcdgwzgttprlzlhmzazhnkwjzvb"	"ljgyddgrhzwbatjsfosycvcgztpllmahkjvxpxspwtzznz"	TODO
"adilvhmluoidibembrzbiqiaugijjwolimfhgrawvtcxinccqfqobgibutnjrpwcwgfoyfgmif"	"dhobrqgwmrtnfgtpgffaivmuiiebziiuijoifgavcicqqbiunrwwfygilldmbajlhwxcobjcom"	TODO
"smohugdkdlsahqstshgpvpebrtvlwejewketekkbjrdsumchfdlgiqfotscc"	"mglqhptekkrmdqssouddshssgvervwjweekjducfliftchkatpbletbshgoc"	TODO
"uwglncolixjp"	"wcxugnoijllp"	TODO
"uwjwifskyvmnhgbojawujupraadlqtinsjnlmaupxzeefnejohevvyvsoesofjpkexrtzf"	"wfvgauatjaznhyejxfujisymhbjwjpadqisnmuxefeoevvosfperzwknourlnlpejvsokt"	TODO
"coxyjyj"	"oycxjjy"	TODO
"xxlwrncddrk"	"xnrxlrcdkwd"	TODO
"sefplavugmsuamuprthzlevewrxebsdzgtlstmkmvbzipknbxbjjcahbpzmvjfspgsqqryxsdngzexrvbgqqctaktqrtekup"	"eammterstmbkbazfsynxgtqksflvgsaurhlvwxbdgltkvzpnxjchpmjsgqrxdgerbqcatreupuupzeezsmibjbvpqszvqktp"	TODO
"xhlcwlekedauhlofzggerjpuzfaamnviddoetvbzltpwxdrkjquupciyzvcfwcorscrecryqviyspejtozoywavvyu"	"hldlgjfndvtdqcvccriezauxlweeahozgrpzamvdotblpxrjupizcwosrcyvypjoowvyckufeuaiezwkuyfreqstyv"	TODO
"viqvq"	"ivqqv"	TODO
"qttjlwy"	"twqtlyj"	TODO
"qmnhbxklwphxr"	"mxpqnbkwhrhlx"	TODO
"udduk"	"dudku"	TODO
"ydbbxlkjnmdchotuvwssrqedxadzhbtjlkcksbamzdthgadativxpwtnxytwcfhykcdlpozkjjjhvftmlyxoyytox"	"dlmowqabkbdaiwyfcojfyyybxkndhtvsrexdhtlcsaztgdtvptxtchkdpzjjvtlxytxbjcusdzjkmhaxnwylkhmoo"	TODO
"pnbibcoqlwkvblxjjvbnwfcwuaoferprudozddgqvd"	"ncwlvfardddpbbolkbxjbwcuoepuodgviqvjnwfrzq"	TODO
"ljwbec"	"jclweb"	TODO
"kxxljmn"	"xmkxjnl"	TODO
"osqg"	"soqg"	TODO
"krlputnx"	"rtklunpx"	TODO
"oqws"	"qows"	TODO
"ojozxczwhqviyfjpinwvjairegzgapbpoenloelylvupbumugdulrqrvpsmeasijiavkrqrvmumbnghsqbokuoiitiqlsrtyorjyig"	"jcqfnagpeevudqssaqugboirrgooxzhvyjiwjiezabonollubmgurrpmaiivrrmmnhqouitqstojizwipvrgplypulvejkvbskilyy"	TODO
"savwtcamxtlnvlykexziabsteceseomhlguldoaipgcwmhnasf"	"actlxbcogoghfsvtaxlvyezaseeemludapcmnswmnkitshliwa"	TODO
"bckd"	"cbkd"	TODO
"povjrbjdualbrrlrnbc"	"obarbpvrjulrlncjdbr"	TODO
"uinyiplrobvdhfrcutg"	"ipbftunilovhrugyrdc"	TODO
"lhedjp"	"hplejd"	TODO
"vayncz"	"azvycn"	TODO
"bczdgfvmkugfhuppbwrkywsmyhhyoqzqynfmtawbsjgraw"	"cfuuwwhqnajwbzgvkghpbrysyhozyftwsgadmfpkmyqmbr"	TODO
"fgtyozamcvzzlbl"	"gzvbftoaczllymz"	TODO
"uvreu"	"vurue"	TODO
"rxpbx"	"xrpxb"	TODO
"lhox"	"hlox"	TODO
"gwdxpasvphbrceaxx"	"wahegdpspbcaxxvrx"	TODO
"pidg"	"ipdg"	TODO
"adh"	"dah"	TODO
"jntpa"	"njtap"	TODO
"brbpsieqcjyambivaetdmyxktwufomuaxpx"	"rijbeywmpbbsecymiatmxtuouxxpqavdkfa"	TODO
"lccqy"	"clcyq"	TODO
"vsp"	"svp"	TODO
"obi"	"boi"	TODO
"qwmp"	"wqmp"	TODO
"shgvlbuaknwsttzchwqm"	"hbntwsglukwtzhqvascm"	TODO
"fclroseuea"	"csafloeeru"	TODO
"pod"	"opd"	TODO
"qcotsqmvhbweeizfffhspgldqznrtpkbuaelyxlolczkubvjtmonopqggqjr"	"cqbifgzpaxcbmpqqosmhwezfhplqntkueyllzuvtooqgjtvefsdrblokjngr"	TODO
"pufgbfrqottdkdcbgufevpnfplnijnu"	"uftduplnpfbrotkcgfvnpnjugqdbefi"	TODO
"wwarbdbhifbsbhww"	"wdfhwabbibbwrhsw"	TODO
"tkgnug"	"kgtgun"	TODO
"gxzobzxryryjxof"	"xzrogzbxyyxforj"	TODO
"gtdbablnelsv"	"tblgdalesbnv"	TODO
"ayykhqbpzqwq"	"yqqayhbzwkpq"	TODO
"kiow"	"ikow"	TODO
"towrs"	"otwsr"	TODO
"kxdeobzraqhytkltazsardaxwvumqkwwcmxuveudvd"	"xbqkzdvkmedkdozahtlasrawuqwcxvuverytaxmwud"	TODO
"rpuowpipuzlcxhl"	"ppzhruwiulxlopc"	TODO
"dyolmu"	"yudoml"	TODO
"ave"	"vae"	TODO
"sxrfaoqtdmirgdadjmszxtoms"	"xomdmtsraqdigajsxosftrdzm"	TODO
"sagdlkjlfhylrkbacdkvpepbnxhkqywlekroztykhsexjnljluyzq"	"akhkdexyktsnusgljfyrbckppnhqwerzyhejllyqdllavbklokxjz"	TODO
"gybwbvcbrd"	"yvdgbbcrwb"	TODO
"tcecuegybaetqgjozo"	"ceagoteugbeqjzcyto"	TODO
"wcshueqjiyhupd"	"ceydwsuqihphju"	TODO
"otdpmkfrfxkaik"	"tkxkodmffkipra"	TODO
"zakf"	"azkf"	TODO
"euxpkxyokukucdfv"	"uxudexkykkcfpouv"	TODO
"mdiq"	"dmiq"	TODO
"jyaunbmewqqwnehvscxkcptudgfomnkwbtemphqupjdsxpgmfkvzlfeqrk"	"ybqecpgnthjpkfkjanmwqnhsxctdfmkbepqpdxgfvleruewvkuowmusmzq"	TODO
"qyhlnbxydjggymigtudjkkuocyoaqnngdftldzrygkmpekqnpibouacvvx"	"ybjmukynfzkkiaxqhnxdgyitdkucoqndtdrgmeqpbucvlyggjoaglypnov"	TODO
"sogee"	"osgee"	TODO
"ozzzwhzhzkqvucsavbqnnjomotnjuhtrkaatjbkjgfhelixvtmnazaaydisi"	"zhkcbjthabfimaiozwzzqusvqnoonutkajkghlxtnzadszhvanmjrtjevayi"	TODO
"hcpvsp"	"cphpsv"	TODO
"pkycrlwtc"	"klpyrwcct"	TODO
"jovbsaujomzzlca"	"oamcjvsuozlabjz"	TODO
"rbwyobhyyajsbjioukhu"	"bbajkrwohyjbiuhyysou"	TODO
"vhzumkboczcashv"	"hkzhvzmbccsvuoa"	TODO
"jsrlxqjfwxhnapkfslgnlfgyknnpxynltrdjfozcwygwwlmmixogvwcatspoztswssuzokkjktsgcsfwurfieplvikowpaggucjezjuaxghocnfclimrmjvpcz"	"sqxplfnyroylxwstsktsrpkacjgnijzjrxjwhaksglgknxntdfzwgwmiovctpzssuokkscfufeliopgujzuxhcflmmvclfnfnypljcwmgaowzjgwivwgeaocrp"	TODO
"pgnpclqlbpcjotkjwqbrwepfo"	"glptqepncqbcokwbwpopljjrf"	TODO
"dfgjrforibrzzeebfvjxuzfpapkltguzloqfw"	"ffbevzpgodgroirzefjufaktulqwjrzbxplzf"	TODO
"clwhxynsclhzrw"	"lylwcwxnchrhsz"	TODO
"mcaewpqibppcieitb"	"cppemawqbpiibeict"	TODO
"cnwupnegwusxgamfocawmxbdybxinngebkivslcmjvdskfctbdypggddbqjcycmswsirngqgoskinopcslvelyaynayslitefnzbxlequuzyjwdqreoydn"	"nnuacxbnklvfdgqcsgsolyainluwencwpewsgmoambyxngbiscjdkcbygdbjymwinqoknpsvlanyltfzxeuzjdrodugxfwdievmstpdcsrgiceysebqyqy"	TODO
"gvvqg"	"vgvgq"	TODO
"iwnowlz"	"wlinwzo"	TODO
"xzem"	"zxem"	TODO
"spcucd"	"pdsccu"	TODO
"hhqdgekwinzgbacmqweywfwosliwopvgzwpcubkjrsgekneegbkoquoeespj"	"henawflpwbsnbushqgkizbcqewwsiovzpukrgkegkqoepdwgmyowgcjeeoej"	TODO
"uyphujwqfmtprwyhyjncaqqjrrksvffazxvlvdakhgd"	"yjmwjqrfxdgupuwftryynaqrkvfzvvahdhqphcjsalk"	TODO
"cpbljp"	"ppcbjl"	TODO
"zurvlikjdqszjdnshyxgzgdrjjnfoiufpqtgwsysobsiqlariaqhsoskkqdgxlzeheipibrjlfjrwczuxzudsxymvxvrspme"	"uiqdygjiqsblaoqlebfczxxpzrlkdsjnhxzdjnouptwyosqaiqsskdxzhiirljwzxusyvvsmvjzsgrffgsirhkgepjrudmre"	TODO
"yrlcgnpgrhitn"	"rnhylgprincgt"	TODO
"mkykgbfqqufnihqyoxwqzkngdfqrxd"	"kbuhxkfdmygfqfiqowzndqxkqnyqgr"	TODO
"ilrxphsrdaddzinywoelwabvotcvkfpbzosqewopeysecmvtkzhqmrdvcbcosfwpqftqjv"	"lhaioatfowymzrbffvirpsddznwewbockpzseoescvkhmdccswqtjxrdylvvbqpetqvopq"	TODO
"kmzujlvjmurcm"	"mlukzjvmrmujc"	TODO
"bncc"	"nbcc"	TODO
"rijhic"	"icrjih"	TODO
"tdumhyodjchrqlghbqhlepmoat"	"dyclqpttuhojhqgbhemamdrhlo"	TODO
"esqvgpkmoo"	"spoeqgkovm"	TODO
"eangvotgrdmawsihnawzcxryfrpnjkwnqosppegmjckensnthjbk"	"aodsaxrkoecsjenvtrmwinwcrfpjwqspgjknnhbggahzynnpmetk"	TODO
"mjhyqswrnhfsckzhpjjojnuecljrue"	"jshkjnlemhqwnfczpjjucjuyrshoer"	TODO
"iyr"	"yir"	TODO
"yattqsoralxxhrjsslkzpekdolnfaksy"	"aslrlelkytqoaxhjskpkonastrxszdfy"	TODO
"pbwbyatevntbkhngphblenbpsbpxnwlqidqcxpvyvwscjhbvxiagxndncstsiwyihiwcfhfmhxbumrqwxehpjgltfkl"	"banhhnbwdpwhinswihxregkpwytvtknpbebspnliqxvvsjbxaxdctiyhwffhbmqxhjlflbebglpxqcycvgnsicmuwpt"	TODO
"efq"	"feq"	TODO
"vlhmznqnilohlnjjaogouvxedufalnnnqfuizwwtmbpmfzqk"	"lnlnovunfwbzvhzqioljaguxdflnquzwmpfqmnhjoeanitmk"	TODO
"tbudcvdrgdbkraqeykhkajstqpnmzdotujbrvdznsieefsnhguemphjeihvxmnu"	"bvdakjpdjdisuhhntucdgbrqyhasqnzoubvzsefngepjivmudrkektmtrnehmex"	TODO
"fpllqrlxnklxjkvasefvuaflnvaovebx"	"prkkeaveflqlnljvsfufnavblxxavlox"	TODO
"gcbfzwankuezalswgnkfmwrjfkwcyybtpwkuqlegtjhfoatiauhnymfkpueyjjikptypcetcaauqksteahaorni"	"cwulnwkywljaumujteashngbzakeasgkmrfwybpkqethotahyfpejipyctauktaarifnzwfjctugfinkykpcqeo"	TODO
"qkayp"	"kqapy"	TODO
"aukngyk"	"uyakgkn"	TODO
"ocepn"	"coenp"	TODO
"lsrsffccgevphqjwfwkunmcplllpjcmwathbaedamvqlrobyiowz"	"sfeqwmlctevoolrfcgvhjfknclljmahadmqrbiwscpwuppwbalyz"	TODO
"bfvuhlntrczxkrjspdibeeebbshjnbpyoaotgawndivtjgsjfjubierdksarjjdcotbctstiomnxbbdgxv"	"flcrdesbaaigjesjtsmbvbvhnrzkjpieebhnpoogwdvjsfuirkajdobttonbdxutxsbbjytntjbdrccixg"	TODO
"pnqdjfxhxxaslxxrebtkbghjhjptrcakxusve"	"nfxxbgjcupqjxxalxetbhhpraxsedhsrkjtkv"	TODO
"mvhvog"	"vgmhov"	TODO
"meosyuixjvpluewswubakfrmfnhrifflxphekwptpzbgxjhnnxkonjhcb"	"euveufnfpwzjxjmoyijpuwwbkrfhifxhkppbxhnknhbsxlsamrletgnoc"	TODO
"vijo"	"ivjo"	TODO
"novo"	"onvo"	TODO
"iyvdlqlgwhsvmpfqkzyo"	"yqhpzivllwsmfkydgvqo"	TODO
"yewpdbihymmhtijqqboteqibepbk"	"ebmibqpywdiymtjqoeiebphhqtbk"	TODO
"bvbhyywtpamxdfueuwvvlacdqrsakounehzhyyxhbrtzlioijxdzrhmwzyzwefj"	"vyafwarohyrixhyfbbywpmduuvlcqskuezyxbtlojdrmzzejhtxevdanhhzizww"	TODO
"cwtrwhfrx"	"whctwfxrr"	TODO
"tjjvlisaggcvsn"	"jigntjlsgcsvav"	TODO
"eqlbzbxhoirjlzsiphnqjwvokwfsujnwkavuhaxkuqadtbzeejjqlihcktvrvghesfljgyoeojiqjrbqzalkegaxbya"	"qbizhwwjaaqbjitgfyjragyelzxorlspnjvkfunkvhxuatzejlhkvvhslgooijbzleababhjiqoswukdeqcrejeqqkx"	TODO
"lfgrbnodaazq"	"fnalgboazrdq"	TODO
"drsgbygpqjbjxk"	"ryjkdsbgqbxgpj"	TODO
"ukurxdnoravqugaxniwewfnx"	"kdagifuuxnrvuanwwnroqxex"	TODO
"prisjpafcmsvmlmohtv"	"rpmltpijacsmmhvsfvo"	TODO
"evajlh"	"vhealj"	TODO
"sxvrpb"	"xbsvpr"	TODO
"qsdzzcpfe"	"scqdzpezf"	TODO
"nnxaqtmhlpddbqo"	"ntpqnxqmldboahd"	TODO
"rctwxkcovrlwe"	"ckrrtxcvlewow"	TODO
"hirxeftxnyoiheciqxwxqsntdkpqlhy"	"ifyexskhhretnohcqwqndplyxxiixtq"	TODO
"mvcioyiw"	"vymcoiiw"	TODO
"urgyovlxabjacacuoxx"	"rvbaxugolajccoxyxau"	TODO
"tno"	"nto"	TODO
"hxlkvjlbre"	"xjehlvlrkb"	TODO
"yejlmlhmyqmexjolpjwcfvfn"	"elqjjvyjmhymxopwfflmelcn"	TODO
"gidtkfanduczmcqnbdyy"	"ifucdgdkadcmqbytnzny"	TODO
"ykptaoqemotpmmccthyqqwp"	"koomhwypaqmtmctyqptepcq"	TODO
"xsxvjijuaemzomajjzmeiymrlrwdswmoowawgptottooubgoxnldspxsr"	"siemzyrwwptbnpxxjjamoajmimlwsmoagttougxlsxrvuzjerdowooods"	TODO
"sjpwfwzuyunwvdk"	"jwudspfzynvkwuw"	TODO
"urxofltoemygbpxeydxezycirpuqpevbtqnxzxtdyqgojdwynvatydjgieozymqrzbqcailswpvcxpnjudlydkhpqhwtozmmtusfhgdglmwown"	"rlmpdypeqxqdvdembippdkhzugmnuxfteybxyxzcrupvtnztygjwnayjioyqzqalwvxnuldhqwomtshdlwwoogeeiqbxdoytgzrcscjyptmfgo"	TODO
"ycidrhvqmhbnehtivknucm"	"chhhkmyirvmbetvncdqniu"	TODO
"ijckliilnustmygshuyizwrvtkygyqvexdimcetccvuexbnoekyamxvcrfewjrudhogtdlfgtahoxsyqegftecdnvjnxyrbpsysq"	"jiuyuwkqdevbkxfrolasgcjryiclinsmghyzrtyyvxictcuxneymvrejuhgdfthxyefedvnybsskltsivgemceoacwdtgoqtnxpq"	TODO
"jwbukzritrtvsxejbsmjqbxbquuawrkmwcyeaxbgpehyjaarqzfiojhhga"	"wzrxsburcxeazjajbkrttsebmqxquwkwyabphjaqfohguivjjbamegyrih"	TODO
"caadnf"	"afcand"	TODO
"nxcmteeebpicpfxyjfdoiejcatfmewubizbgnsahqswmwrbifjzmilwgau"	"xepffetwzssrjlunctebipxjdijafeuibnaqwwbfziwamecyocmbghmimg"	TODO
"ljesoqmpoogejhnihkhrwfwwdtytlgjfwqbnqlapxaygvkqmvmkdamsbunlmqzylsefuoygbeiyxkzvrxqqc"	"jqohkftgqlakmmnzeyizqleomogjnhhwwdyljwbqaxyvqvkasulqysfogeykvxqspeirwtfnpgmdbmlubxrc"	TODO
"udaejjrcbfmvzxqsdjqhoeoqfevwihvhovvrbdwbtjazdymtzmcvgmkcklprlhxhjjddcufr"	"djfxjeehvdjymmlhjuuajrbmzqdqoofvivovbwtadmzcgkkplxjdcfecvshqwhrbztvcrhdr"	TODO
"psvlxfyjesdjeysnsnfihctvujnn"	"sfsyncjpvxyedessfhtunljjnivn"	TODO
"rowadzjxplolqqsgjemsqgaaszeohav"	"ozlqegzarwdjpoqsjmqasehvaxlgsao"	TODO
"fobqxtzmmrfdrzriqnbbrjrieoxukm"	"otrznjomfbxzmfrrqbrrexkqmdibiu"	TODO
"mowttwefiwvnuzyjhcxgmpvcamqngtkvdunnrasrlzhqcekhsymtnnicqdeboctuyqswwcehegdcgkxboawagstabglliekelineevfoutuoosohkgfgurwkebj"	"owwzcpmtuazeyndcqcgkasgeivtsgrbmwteivuyhxmvaqgkdnrslhcksmniqeotysweedgxowgtbliklnefuuookfuwejtfnjgcnvnrqhtcbuwhcbaaleeoohgk"	TODO
"lwaurjdfbzbtfgkvlsbocoybvw"	"wjzgsowlardbbfklbcyvuftvob"	TODO
"pzwdk"	"zpwkd"	TODO
"ffbhqwrijjvt"	"fwjfbqrjvhit"	TODO
"jvzltmxwffj"	"vmfjztxfjlw"	TODO
"aausuczlmmqolss"	"acmsauuzmqlsslo"	TODO
"tseutowaoiucghohbqi"	"soihqtetwougobiuach"	TODO
"vnalkkipnkyuoxveprolzvyadxg"	"nkkxrvxvakinyovpozydglpuela"	TODO
"jdsvolhimztauvgmzvupdncnnkyfjssp"	"dlzvvnksjsohmtugzudcnyjsviampnfp"	TODO
"xbqwmoye"	"boxqmywe"	TODO
"ynyemvewujknxtimqyavzqtf"	"nvjtyqyymeukxiqaztewnmvf"	TODO
"agrlvnctacrggoo"	"gncoarvcargoltg"	TODO
"dfwfnahynhvwthiuibwgnouxjaslo"	"fahhboadwnhnvtiiwnujsofywugxl"	TODO
"ktsnwypgnypfyigofwvhokbkgxs"	"tyyiwkxkswpnpygfvobgsngfohk"	TODO
"zgano"	"gzaon"	TODO
"ietbht"	"etithb"	TODO
"ndnkacltjegekdyxocek"	"dcedcnnaljgkyoektexk"	TODO
"psfewrtraqclcswxiqhcbievgyvwa"	"srqsqiypfwtaccwihbegvaerlxcvw"	TODO
"ihsrxwgfzikeieiitpvppohdal"	"hwiepolisxgzkiitvpharfeipd"	TODO
"zelcbhpstldgz"	"ehlzlbptdzcsg"	TODO
"whizegmwkekbcg"	"hgegwiemkkczwb"	TODO
"qixzrtfepfvx"	"itfqxrfpvzex"	TODO
"ginwpqnbmvqsbxfdbu"	"iqvxugnpnmqbfbwbsd"	TODO
"uihpydhxbvdukhmehbxj"	"idvhbuhyhbdkmhxpxuej"	TODO
"nkb"	"knb"	TODO
"zgzzosx"	"gszzoxz"	TODO
"zey"	"ezy"	TODO
"ogvbrqvikobkguilveibwyqsakvobnoaeemftltmdehehdkbyqtasl"	"gqoueykneledqlovrvkbgiviwqavboemttdhhkytsbiklbsoafmeba"	TODO
"ctbxevrapvchslm"	"tvvlcberpcsmxah"	TODO
"ejhvokmntncpkweuzwkcjfuijwpqoyvftmrokbqebqfeacwoljmifzfthiutqwancxtwuxwurhqoefiuxpjmqdraarczaihaqcxgarbzmzhy"	"jknwwfwymbqcjziwxxhfpdricrzehomtckezkjujpovtrkqbfawlmffhuqactuwrqeixjqracahqxabmhvnpuciqfoeeoittnwuoumazagzy"	TODO
"sephywmuxic"	"ewispymxchu"	TODO
"mfruveroau"	"feumrvrauo"	TODO
"gkksdrbmguxeiojquxgirktwcaxyqcbqwcjepaichvgrnelewacbllbkdlhvfzxfhdjxneoacsbjnhfgfhbmrmgtklcuvkfqmcnhyrtiqtxvs"	"kruoxkaccaveallzdeshhmlkcrtgkdbgxijugrtcxqbwjpihgnlwclbdhfxhjnocbnffbrgkcvfmnytqxssmeqiwyqecrebkvfxajgmtuqhiv"	TODO
"pdwhkxzlizuuxiexfafbswyghmqzsrgfdiirckceqnpipkidafihaqvmynxhrtyypqrwmiijkbxoyfvirwtmpm"	"dxziawmriknkfqntqibfwmpwkziuxeffsyhqsgdiccqppiaiavyxryprmikxyvrtphluxbgzfreidhmhywjoim"	TODO
"yczhvjmhqflrchlesvslkzpnnzcokegugofinmhythxzqipreeyudxehhnsfx"	"cjfhvzzeomhiexnyzvmqlclsskpnckggfnhtxqpeydehsxhhrelnouiyzruhf"	TODO
"zvpxjsjsoftbholkjxtburnfbkwpydkiumqerzdzjsksl"	"vsfoxrkdmzszpjjothljtunbwykuqrdjklxsbkbfpiezs"	TODO
"mxklfvuamgmruejlmje"	"xvgejmkfummujmelarl"	TODO
"gpnepsfnqoaxvwejvfrhqnmdtbicfvuncendtgyggwbnujpzrnljdipsvrhkaqytaqwehrljfudhvbkmmnzazmvzisyxxjxy"	"psowfnbvegwjnirqqrubnmsjgnpfqavevrqmtifucntygbuprldpvhayawhlfdvkmzzviyxxenxjhdcndgnzjsktejhmazxy"	TODO
"coiclcpqqrfu"	"ocrcilpqfcqu"	TODO
"fomcr"	"ofmrc"	TODO
"xen"	"exn"	TODO
"clmfwsxwvlmmewlvxhgevnjxnvsgmffkzlaomnaemqquyrdvlxaslhvyjzqrxsfa"	"lslwhnvflnqrxhzscmwxvmelxgvjnsmfzamamqydlalvjqxffwmvexgkoeuvsyra"	TODO
"wpbzidxcyzvmmbuhbwtslekdhqvlyciubsekxwocezlbeiutcsxbwhnyqsi"	"pdzbweqcswzishswbixyvmubtlkhvyibexoeleucxwnqizcmhsdlukcbtby"	TODO
"wgkxckrepnzqcnxq"	"gknnwkcrpzcxxeqq"	TODO
"suttzpr"	"upstzrt"	TODO
"cgxudhpasrxvfcqvchrcxoupilhcwmzkyyybyizbtvda"	"ghrcholmyivcxdpsxfqcrxuihwzyyyztduavvcpckbba"	TODO
"wpsaetdmzbgqcl"	"ptblwsedzgcamq"	TODO
"dyvpcobfhnuuhh"	"yonhdvcbhuhpfu"	TODO
"dtvmdthkxlng"	"ttldvdhxnmkg"	TODO
"wet"	"ewt"	TODO
"bvoihzasntocpjggdustshzbncluwvjzelxgmocf"	"vztjuhcvlobohanopgdssznlwjexmciscgtbuzgf"	TODO
"zoynrz"	"ozzyrn"	TODO
"xhsotegrjqvzvqzyvbhqdowdbqvdzamalkjtskexyetnnhnfavqgx"	"heqqboqakkehvxstgjvvzvhdwbvzmljseytnnaqxorzyqddatxnfg"	TODO
"jpb"	"pjb"	TODO
"skg"	"ksg"	TODO
"oyeauwdkaefxgeuiz"	"yweeoeudafguzakxi"	TODO
"bspwmdpwbaunxo"	"sdaobpmpbuxwwn"	TODO
"fko"	"kfo"	TODO
"zlgohutxbaypevraxpewjtxlmioorxnporqxmnmrfcodtbjajlpkzsjzgieibd"	"luavptixrncblsidzghtbyerxejxmornoqmmfotjjpzjgeboxpawlopxrdakzi"	TODO
"gbme"	"bgme"	TODO
"ryqbnfgwf"	"yfrqngfbw"	TODO
"znlcmhnsdcdzyrtkwcoytxdggurckwwvlxzmjfjtvu"	"nhcrcxuwxfuzlmnddytwotdgrkwlzjjvcszkygcvmt"	TODO
"bohdv"	"obhvd"	TODO
"gbatvgunlvbxafrgbffalcdgrisz"	"bgvffcigavulbarbfldrstnxgagz"	TODO
"bngciacspfeuprlpigaumadhywzgfgmfsljthsradydnppbrubchmkfurccdchwlugdvovlugesdmletmanfrxkmsznoehttz"	"nafrgawglsypbkchgvelaxzhbgicpepliamdyzfmsjhrddpbucmfrccwudolgsmemnrksnetzcsupuhgftanrhudlvudtfmot"	TODO
"beadbkrrrufkrvmngqaktbfhlwfilcnnzibeodnqbapvodhhkyonnacdoaqvywlulkklxfkipcxsr"	"ekuvqbwcidadyaawkfcbabrrfrmgatflflnzbonbpohkoncoqyllkxkpxrdrknkhineqvhndvulis"	TODO
"toldu"	"otlud"	TODO
"byuxiermuf"	"yefbuiruxm"	TODO
"glsnrigcdvnrhqykcxbovfkkvltdszvuagxecjrcvllsmbdungubpxterylbmb"	"livqxflzgjlbgxybgsrgdnhycbvkvtsvaxcrvlmdnuptrlmncrkokduecsubeb"	TODO
"oqgtw"	"qogwt"	TODO
"woeizntqrkgcarybvqjhfqhtsgon"	"onkrqqgweztrgayvjfhsoiqcbhtn"	TODO
"pmeecgweepoezxxualewkk"	"mgpxlkpecweozxaekeeeuw"	TODO
"ufgqwgxmiwrmaqspciniohnjtuapudelgkfwpjkdxnkuxljsrdglbleqnapwpsvneetpfkzohgeyimgzmwachwlecjcxtqdrlvxifpmhy"	"fgwqihudkjnldlasekgmwwjqvpugwxirascnontauegfpkxkxjrgbenppvetfzheigmahlcctdlxfmyqmmpijplwduslqwnpoyzcexrih"	TODO
"ldrlklsengstasl"	"dlgslrksnsallet"	TODO
"xvyjcwzhckroxdhe"	"vwkdxyczcrxhjhoe"	TODO
"fvpepnyxhetlwuzbbpzitvsmrwzzjtfhzvciquluogvmsclkqqg"	"vneupvwtvugcqfppyhtwzbztsrzjfzcqlovslqgexlbimzhiumk"	TODO
"rhmdzehjnugmvvyp"	"heuvrmzhngvydjmp"	TODO
"gyukohxazqhfmozllcggmtcalmegujdsfawcudmtndfhjeatyudtmlnnpmybodnpgynsllzcnlchepohapyuxzgyjmlkjrnsekfptclbzbxeeybqlaqigr"	"yhqoctmjaddeulmdyllppzmrkcbyarguoxzhmzlgmcleudfwumnfjaydmnpyongnlznceoayxgjljneftlzxeblqgkaflgagscthttnbpschhuykspbeqi"	TODO
"eydkrorrtzyfxjx"	"yozjedrrtyxxkrf"	TODO
"yik"	"iyk"	TODO
"ecqywpo"	"cpeqwoy"	TODO
"mpecuxw"	"pxmeuwc"	TODO
"dlqxdarmtzuomawknaruy"	"lazaadqdrtumwnryxmoku"	TODO
"afydvantetmayvoknxdmrfczlshkx"	"fatvxfsayvnemyondrclhxdtakmzk"	TODO
"cuchpsciyclqtiquxkjtkfsehodrw"	"uscikfoccpcyltqxjkshdwhiquter"	TODO
"wbdtcdadiveygdxiaghmfmsdpwfgyybeijlsjneqzhahwjhuvibiruscbq"	"bdvdgmwyjnhjiuqwdcaiegxahfspfybiljezawhvbrsbtdyimdgesqhuic"	TODO
"iusplngjkdac"	"undislgkapjc"	TODO
"hdqckn"	"dnhqkc"	TODO
"vfsiocpyuxrpaigonogknamycpzbgfx"	"fcxioapfvsopuragngnmczgxiypokyb"	TODO
"fhxcnbgumkwaslbejokkmrwdpvavojbnmucdapqdnuioowujabonaldbbvyaxwehqhtjdzxgbywsekyrjqzsxf"	"hbklorvjupuwblvwhzykqffxngmwsbjkmwpaobmcaqniouaoadbyxeqtdxbweyjzxcuaekdvnddojnbahjgsrs"	TODO
"gfcyx"	"fgcxy"	TODO
"qmqgspfof"	"mpqqsffgo"	TODO
"xmirfuxo"	"muxifxro"	TODO
"enphypzbsugixbtjdkjjnizmbpobrfyvzcczgunfesjxuzbeffigcsvazgthkbronxxughtoakjzejiuftxkaqxofreticvddndtcwjfjaywdzlv"	"npubkipfcuszfsgbxhkjtqrcnwazepyzsgxtdjnzboryzcgnejubficvztkrnxgtajeifxaxfeivddcjjydlhbijjmbvzfxegahouozukotdtfwv"	TODO
"lzjxkpadoxbyrnkvmthpvlt"	"zpxntlljkaobrkmhvtxdyvp"	TODO
"ejloennyomtrvmzycafnnpmhm"	"jnmmapelenotvzcfnmmoyrynh"	TODO
"wezkcwinpaxq"	"ewawzcipxknq"	TODO
"umgsgrgirztrosqmupkdcjyjffdrkezynxnktlacngmijmrpbrmjgwqftvaeznaginqffpzlprmaulhchxjhztgjoouzgirgqgmdvsozikjtzeelmwvpir"	"mrzspjfexlgmrwvnnprlxtoigskewrugggrtoqukcyfdkznntanmjrbmgqtazaiqfzpmuhhjzgougrqmvoijzemvisirmdjrykcipjfegflachjzgdztlp"	TODO
"mxpuflllhbawve"	"xlbempflhavulw"	TODO
"qaiuxxmhjoaxhgtvydcwwittvvryprafeocterrjtqfjxbczjyexkmtbpyauxhvgkfvhtlzqkynqegyiedlmdphqysaslihpamkupxmgngnaaarrpkfhfajblmuza"	"axogdivrorqbymyhflygdpsimxgakamqixmjahtycwtvrpaecertfxcjektpaxvkvtzkneyeldhyalhakpmnnarpffjluauhxvwtyftjjzxbughqqimqspugarhbz"	TODO
"sdgnbvoztnohwwurrxjmtbovvcryrwyjfakvriguroghmsjyfpsdbiagdnllsogdjxneykrhozdzqetqzextadunhawsbcvjyuhob"	"dvnwxbcwaiospinoxkzeedacusgbotowurjtovrryfkrgrgmjfsbadlsgjnyrodqtzxauhwbvyhbnzhrmvyjvuhydgldehzqtnsjo"	TODO
"ltbwvmhjwevdpxdri"	"tmexlbvhwvpdiwjdr"	TODO
"evqamnslaqubhsjkxxqbrabpkdfceutkmeoujtagquxmvhdusnogxowwcaitoseunvitvcstdmhuhcnivwqqsyblsfhdyivxmqpdchqpudamjlmkj"	"vnqsxaduetuhnoasvcmcwyfiqhdleqmsauhjxqrbkfetmojaqxvdsoxwcioenivsdhhnvqsbshyvmpcquajmjalbkbpckugmugwtuttuiqldxdpmk"	TODO
"hdfstkmmeawsltnkwmsq"	"dkatmhftmewlnwssmskq"	TODO
"jukceakt"	"uajkekct"	TODO
"crcbv"	"rccvb"	TODO
"adxvjncvzsgugsosocmfogibkqhnjdipe"	"dnsscgqdaxjczggoomoikhjievvusfbnp"	TODO
"tpylgqv"	"pqtygvl"	TODO
"phrbw"	"hprwb"	TODO
"ktj"	"tkj"	TODO
"ypwroglywmumpnhhxmhieyhikjjpbptplnmmtcjwpmfsefppstcpgitmelmhd"	"pgmnmyjpncmftilywolwuphxhehkjbtlmtjpfepscgtemdrymhiippmwsppmh"	TODO
"qnbqvquqax"	"nqxqbvuaqq"	TODO
"xebfndlzgncky"	"ednxbnlgcyfzk"	TODO
"pslenromfdpkfemujfkdezcvcmbsbf"	"srdefzmfplnofpfmjkeccbbemkudvs"	TODO
"yvdcoefmcpyjjmjjcztbdxrramselriqawkzitzaosvymqialahaxzsgxegw"	"vepmzxmrwtsqazeydofcyjjctdrasliakizovmilhxsxgcmjjbreqzayaagw"	TODO
"bjyrfgquejjiugdqflstrzoqoushwiahylojezsfwelskwlpomjcyxcumyccewzceabwplrszeooskbfmddxlgmeyaybuegwun"	"jgjglzuilzewmxywalekdgaenbyfqejudfsrooswayoeswlklojycmcezebprzosbmdlmyyuguruiqtqhhjfspcuccwsofxebw"	TODO
"sxqtmqfwpcwqitkqdafeqrqhjwiswbflzcrzltwkvuujuhfbmexeanfld"	"xqctarwbctuhensqmfpwikdfqqjiwfzrlwvuufmxafdtwqqehslzkjbel"	TODO
"sgg"	"gsg"	TODO
"zogldts"	"otzgdsl"	TODO
"kydfypmruoajfdtuutuseljwakxqkkbihciysnswzzakghxsjhownqq"	"ypodtlkkcnzhhqkdymuaftuuejaxkbhisszagxjonqfrjuswqiywksw"	TODO
"gbrrourlcjfivhvqev"	"bujhvgrorcfvverliq"	TODO
"ywbd"	"wybd"	TODO
"elcatezeslcwgtqdofaewpmhtpenvnwjrvaqmilql"	"leltfppnviectzscgqoawmtevwramllaewdehnjqq"	TODO
