string	array(string)	array(int)
"barfoothefoobarman"	["foo", "bar"]	[0, 9]	TODO
"dcacdabcd"	["cd", "ab"]	[3, 5]	TODO
"nwljkkeupjkknwlswd"	["jkk", "nwl"]	[0, 9]	TODO
"rndljjljjrndkzxljjrndsnq"	["rnd", "ljj", "kzx"]	[6, 9, 12]	TODO
"sleuklluklluklluaoprsleu"	["sleu", "kllu", "aopr", "kllu"]	[8]	TODO
"hibsoibwyjuaavaaamibswibsujyymibsoabkgtpadbwxjkg"	["vaaa", "ujyy", "mibs", "wibs", "mibs"]	[13]	TODO
"eddvuieddvui"	["edd", "vui"]	[0, 3, 6]	TODO
"n"	["n"]	[0]	TODO
"n"	["n", "n"]	[]	TODO
"ddd"	["d", "d"]	[0, 1]	TODO
"iii"	["i", "e"]	[]	TODO
"sss"	["ss", "ss"]	[]	TODO
"oooooo"	["ooo", "ooo"]	[0]	TODO
"zzzzzzzz"	["zz", "zz", "zz"]	[0, 1, 2]	TODO
"vpvpvvp"	["vp", "pv", "pv"]	[1]	TODO
"ojojojoj"	["o", "j"]	[0, 1, 2, 3, 4, 5, 6]	TODO
"qkqkqkqk"	["q", "k", "q"]	[0, 2, 4]	TODO
"hphphphp"	["hp", "hp", "hp"]	[0, 2]	TODO
"zczczczc"	["zc", "cz"]	[]	TODO
"hhhgggq"	["h", "h", "g", "g", "q"]	[]	TODO
"pdppdpddpdp"	["pd", "dp", "pd", "dp"]	[1, 3]	TODO
"jsjjsjssjsj"	["sj", "js", "js"]	[1, 3]	TODO
"wwggwwggwwgg"	["gg", "ww", "gg", "ww", "gg"]	[2]	TODO
"ljzzjzzjffj"	["jz"]	[1, 4]	TODO
"majjajjappa"	["ja", "aj"]	[1, 4]	TODO
"yiccicciqqi"	["yiccicciqqic"]	[]	TODO
"chqxzqxzqcqxzqx"	["cqx", "zqx", "xzq"]	[6]	TODO
"fffsftftt"	["ff", "sf"]	[1]	TODO
"gmfffmm"	["ff", "gm"]	[0]	TODO
"zdzzdd"	["dz", "zd"]	[1]	TODO
"ligillglig"	["llg", "igi"]	[1]	TODO
"jiivjvj"	["vj", "ii"]	[1]	TODO
"vttvtt"	["vt", "tt", "tv"]	[0]	TODO
"zzzvx"	["zv", "zz"]	[0]	TODO
"tzlttztzzt"	["tz", "zt"]	[6]	TODO
"qxqxxqqx"	["qx", "xq"]	[2, 4]	TODO
"bsnbsbn"	["bs", "bn"]	[3]	TODO
"ddrvdv"	["dv", "rv"]	[2]	TODO
"bbjyjyybjb"	["ybj", "yjy"]	[3]	TODO
"iwiiiwww"	["iw", "ww"]	[4]	TODO
"iuiiv"	["ui", "iv"]	[1]	TODO
"zlliili"	["li", "ii", "ll"]	[1]	TODO
"ccqrrrrrq"	["cc", "qr"]	[0]	TODO
"lleceeccce"	["cc", "ec", "ee"]	[2]	TODO
"fpppfppff"	["ff", "pp", "pf"]	[3]	TODO
"tpptt"	["tp", "pt"]	[0]	TODO
"cccgycc"	["yc", "cg"]	[2]	TODO
"vvvvjddjj"	["vj", "dd"]	[3]	TODO
"fgggrfgffg"	["fg", "ff"]	[5]	TODO
"nnvny"	["ny", "nv"]	[1]	TODO
"ttctctcr"	["ct", "cr"]	[4]	TODO
"shhhhhsphp"	["hp", "sp"]	[6]	TODO
"dddyydwy"	["dy", "yd"]	[2]	TODO
"qzqzzqzdd"	["qz", "zq", "qz"]	[0]	TODO
"pppcoccppc"	["pc", "oc"]	[2]	TODO
"fdaafaffdd"	["dd", "fa", "ff"]	[4]	TODO
"nppnr"	["pp", "nr"]	[1]	TODO
"eqddedeqdd"	["eq", "dd"]	[0, 6]	TODO
"nnanjann"	["nn", "an"]	[0]	TODO
"pjffjjjfpf"	["jf", "pf"]	[6]	TODO
"pwpowwpoop"	["wp", "ow"]	[1, 3]	TODO
"bbba"	["bb", "ba"]	[0]	TODO
"yykyktkt"	["ky", "yy", "kt"]	[0]	TODO
"rrxrxr"	["xr", "rr"]	[0]	TODO
"qrrrqqqrqt"	["rr", "qq"]	[2]	TODO
"tqqxqtqxt"	["xq", "tq"]	[3]	TODO
"uuuweeuee"	["wee", "uuu"]	[0]	TODO
"nennennn"	["en", "ne"]	[1]	TODO
"bnbnnwn"	["nn", "nb"]	[1]	TODO
"ydmyydym"	["myy", "dym"]	[2]	TODO
"eieee"	["ee", "ie"]	[1]	TODO
"ssasassdsa"	["ss", "sa"]	[3]	TODO
"mxzxmmxxzm"	["xz", "xm"]	[1]	TODO
"hhhvh"	["hv", "hh"]	[0]	TODO
"kdhhddkh"	["dd", "kh"]	[4]	TODO
"vvvfffjfj"	["ff", "vv", "vf"]	[0]	TODO
"bbbqqllllb"	["ql", "bq"]	[2]	TODO
"gbboooogoo"	["bo", "gb"]	[0]	TODO
"oooaaaaool"	["aa", "aa"]	[3]	TODO
"fyfnyff"	["yf", "ny"]	[1]	TODO
"cvvvvecee"	["ce", "ve", "vv", "cv"]	[0]	TODO
"xxixxxj"	["xi", "xx"]	[1]	TODO
"ippbippbbi"	["ipp", "ppb"]	[1]	TODO
"iiriziriiz"	["ii", "ir", "iz"]	[3]	TODO
"wbbwbzzwwz"	["bz", "zw"]	[4]	TODO
"iiaafa"	["aa", "ii"]	[0]	TODO
"howoowwxw"	["ho", "ow", "wo"]	[0]	TODO
"zjulzzjuuu"	["zz", "ju"]	[4]	TODO
"pdudddf"	["ud", "pd"]	[0]	TODO
"imkuiki"	["ki", "mk", "ui"]	[1]	TODO
"yypyjjp"	["yp", "yj"]	[1]	TODO
"koxxooo"	["ox", "xo"]	[1]	TODO
"srdr"	["dr", "sr"]	[0]	TODO
"qqezqzqzzq"	["qz", "ez", "qq"]	[0]	TODO
"mkyymk"	["ky", "ym"]	[1]	TODO
"cfeeff"	["ee", "ff"]	[2]	TODO
"anuauaun"	["an", "ua"]	[0]	TODO
"bxccxbv"	["bv", "cx"]	[3]	TODO
"eickkekcei"	["ke", "kc"]	[4]	TODO
"hjdhhjnd"	["hj", "nd"]	[4]	TODO
"ccdccpcdd"	["cp", "dc"]	[2]	TODO
"vddvddqnnd"	["nn", "vd", "dq"]	[3]	TODO
"wowrwwfww"	["rw", "ow"]	[1]	TODO
"xuxhxuux"	["xu", "xh"]	[0, 2]	TODO
"phpppu"	["pp", "hp"]	[1]	TODO
"xaxpdx"	["xp", "dx"]	[2]	TODO
"cccppcpq"	["cp", "pc"]	[2]	TODO
"pmumpuemp"	["mp", "ue"]	[3, 5]	TODO
"ckccflfklk"	["cf", "lf"]	[3]	TODO
"xtktttkk"	["kt", "xt"]	[0]	TODO
"msgsg"	["ms", "gs"]	[0]	TODO
"rrrrrma"	["rr", "ma"]	[3]	TODO
"ddaydyaddy"	["ay", "dd"]	[0]	TODO
"ddllmd"	["lm", "dl"]	[1]	TODO
"ssgsssgs"	["gs", "ss", "sy", "gy"]	[]	TODO
"zbpblujkfczbpblu"	["bpb", "luj", "zbp", "blu", "kfc"]	[1]	TODO
"ddhhdwwhhwdwhyydyywwwyyhhhhdhywdwwdhdyhdwd"	["wdh", "wdw", "dyh"]	[30]	TODO
"eteptpetpereteeteptrttpptttpeertetpeprpe"	["ttp", "ptr", "ete"]	[14]	TODO
"hmhghgimgghmmhiihmhhighighgimmghmiii"	["ihm", "ghm", "mhi"]	[9]	TODO
"qbqbbubbqqqtbbtqbbutqttububuuuttqutqttquubbqbtbbtutqbqtbbtuuuubt"	["uut", "tqu", "tqt"]	[28]	TODO
"nnnqpupqnqpnquunqupquuquupnqnnnnppnunuuppnppunuuqqupupnpqppnuupqnpunnpuupnnnnuq"	["uup", "nuq", "nnn"]	[70]	TODO
"anzzzininnznaiznaziznzainizaizannziniazazzzaiznnzannanazaaaiaianinizziaz"	["zza", "nia", "zaz"]	[35]	TODO
"ppepdrerpdrrpeeeederppdrderrddperdpddddrpdrrderrrerpddperpedrddrpe"	["derp", "eeee"]	[13]	TODO
"gsksgttgssttkskggttssskssktttggtsskskgttsstggggggtsssgggkgtggttskgktggstsktss"	["tsss", "gggg"]	[45]	TODO
"bbgffgbaaaabbafaffaaffgbgfgbabgbffgafbafbaagafgfaggfffabagfaabffabfffgaagagagffgfbfagfbabgabafga"	["abff", "agfa"]	[56]	TODO
"pvvevpvetpttpvtttvpvvpetevevpeeptttptptepevptpteettttetvtvtttvttpetteevepetttevvevpvtt"	["tepe", "vptp"]	[38]	TODO
"afxxrfafaaxfrfxraxarraafxfaaxxxrxxrfxxfaafaxfrfafafar"	["aafx", "faax"]	[21]	TODO
"uuuzziizuzzzzninnziiiuzinizinunnuniniziiinnnzuzzzunnuiuuzniznuiuunniiuzznizziuununz"	["iuzi", "nizi"]	[20]	TODO
"mpzzpccmmcpmzzzzmmzmzpczccmmmmpczcmpzpzmmcmmcmzpczzcpcczppmzzzmzccpcmccczpcczc"	["mmcm", "pzpz"]	[35]	TODO
"gigiygigygignnnnyyggnnnnnyyiyyngigyniiyiyinngiiginigigygggyggnnyynnignyggnyiginyiggyiiinnigygyyinny"	["yigi", "nyig"]	[74]	TODO
"pqxxnqqnxnpqnppnxnpqxxnxqqpnppnpppqxpqpxppxxnxqqppqqxnxxnqpnpxxnqxpqnpxxnnnqpnqnnq"	["nppp", "qxpq"]	[30]	TODO
"xcffqcfcfqffcqqxfcfqfqxffxfffffcqxqqqqcfqqxcqxfqfxqxffxxcccqqqcqfxqfxcxxcqfcxxccqxqfcxc"	["xffx", "ffff"]	[22]	TODO
"uuquuusqqshusqsqquhsqqquhsuuqusushhqqsuuuuhhssqsqhuuqssqqqs"	["uuuh", "qqsu"]	[35]	TODO
"aoavaokovokkoaookvokovkokkkaoaoaaakoaaokakaaovakaavaaoavavkakaovokvvvooakvokavvo"	["kavv", "akvo"]	[71]	TODO
"rrrdgdgrddgnnrgdgnddrngdggrgnrrnrrgrdgrnrgrnrrrgndrngrgggr"	["ndrn", "grgg"]	[48]	TODO
"iwiwuuuwuuduuwuuwuwdwwuwwwiuiwwiwiwdudiiidwuddiiiwdwwiuuwwiwuiwdiwuuiwwii"	["uwdw", "wuww"]	[17]	TODO
"pmmmahpaamaphaahmamaphpmmmmpaphhphhppahhmmmhmaampaahmphhphahmmpphmmmahha"	["phhp", "mmpa"]	[25]	TODO
"mfffmtofmmmottfotmfmfmototftttfmfmotmoftfttftfftommttftofmofmftoooommfmtfmfftmf"	["otot", "fttt"]	[22]	TODO
"hoohholowlowhhlwohlholhhhwhlwowhlowohlllhwlohholwwoolllhloolloohlhloohw"	["whlo", "wohl"]	[30]	TODO
"pbeebqeepbeqpqpbbppeqpqpqebpeebebpeqeeqpbqebpeeqppqepbpebqp"	["pbbp", "eqpq"]	[10]	TODO
"jinjiijnjaainajajjjiijaianjniaananaininaininjjjnannaijaaaijiijnaajajjnijiiajniajaniaaanaiiaijja"	["inaj", "ajjj"]	[11]	TODO
"bzzvzhbvbhvhvzzhvzvhzhvhhhzvbbzhhbhbvvbbhbvhvhzvbh"	["hhzv", "hbhb", "bbzh"]	[24]	TODO
"bsbdssbsddbssbdsbbdddbsbssdbbsddbssbbddsbsbddsdbssbdbdsdssbbssddssbddbbssddsbddbsbsdsbbsbddddddsd"	["bbdd", "ddsd", "dbss", "sbsb"]	[31]	TODO
"ottoyyoootyotttyytottyyottoyotyoyttootttttoootoyyooytyyotytototttotyyotoyttyottooyoyyyytootyotootooootyootyoyotoo"	["yoy", "ooo", "oto", "oot", "oty"]	[97]	TODO
"otytootyotyoyytyyyttoootooooootootyoytoyoooyotyotoyytyytoooottttotyooooottytytotyytyyttyttoytyytotyoyottytoyoottyotytyooytoooyyttyototyyootytot"	["yoy", "tyy", "tot", "ott", "toy"]	[89]	TODO
"mhohmmmoommhhomhmhmmmhoommhoooohhoohmmhohoomomomomhohhhmohohhoomhmoohhhohmmhhmhhmmmmommohomohhmmohohohmhhhomohhmommohhhomooohhomomhhhmomoohohmmhmhm"	["hoh", "hmm", "omo", "mom", "oom"]	[35]	TODO
"rbxamaogxxqcdphqxxctclgjbacrgpatzbfjjoqgzvpbujoefnjgglmzokpxauslltssqatfcibizsmdmryrbppvtkvccdmkmziamlbknlxiekwhzvmrbwhjdmgnptqsqxfwludghhdtlksydzmrlgvjrexwjlxmqfhwuiewawfdntzupfjsqbtaqvjmzgexgvtzggkzesaadrmxvvvbfhqqrmacrpfautrhuealfphntqynekaelinucvituoxmmkgyfzlcypytrdrcqyzveejzgdpzuqjybmnacqbxkbvzshduoaptqqpkjsgzbmipwuoahrblxffvydcuvqqitvcadpkttfuxzvbudpholhqpzknptcnytywkpdoenwbinlrosqaigddhjicedyekhgijfaunflbxwxznprakpvpkqmycmwrqegluuneuqleiqreripunuhqhgpnvukervhfczbondvbfoqvwvgtpcuxldyuamlhojynobeztcstneytcgyppeqswqfftlymkhppsoxhnkrdyrmctlmehajrijrlsrwupineanasqxmqkalhoaaijbfhzvgjzidxsibxbgrhgecvlklcyhzjvdxgmjmfhjcmheltdukyrssboiiiashfmdqaxteoaucsrrhqfqgrubfvmuqhgchsncnhbbegqzbejtdpuxbsaanhqjokqeijzuxsmbwarppweyernqzwdevfoqsfngpiogjguuujoobsimiuwwlsperynzyzhcvupahnqtcxlusffpzbuxydumowjolxnzijraxwjcasifsipqlhgpuhwwruluegvsqoxqrclysyyhicfyxqpecupvmsjxwbkzkmyusluopauyuuneyckxzttjhbcspvqaoglgrnxbvewjrsomtcmqwzmskshwoccelmdugzlevdzzlwfoamxjxkaroshewyqzqftsdixqbifnqfuokihrjsidhbwvwolozigetjnchnxgyenlrdbvmrkqfoewahlravffwnjvdgazztxpmeewcyifombrqniokioneykvgdpnmqcenugyahfsqazsvtlolxuhxyrcdwypocouuyemoeuclrwiditczgyogmnydnjbndmaznnbbaihxqahnjyiqhvmqkmfpkecqxuyyabwpmvptxfsgyjmhbejynpjmoqtdytzacmikihdinmdnvpixohnifccdktelykhfbakmvqcktdmhxcnonothnwzqcrwyzvfscketauhfajytgdlcboxaridrgsrddrqdznrmbplqkpuwyxabzwpcmxsrkdlqpwfnvkgfavmhunruhymavvuusgjoykyjdfclklkyuaorwpfrjmxboikqdsczixdafdoscgmzucplmpbvtbxkmmwciwhtaefawdneylvumbnboaflqxewmjaxusvqjtoumzlmxzykmnncvhrunxppcoqolufmgoytblzeyuymahkcoziuihooecadiapnsprcvjuvzeirajvkdgxwfdredhwbtzwnhhymneoiltjoawjvigfinkrolhroehutzedilbtagaszgapoultaanshiobsekhvyzgpsaowjpkliafsoaymsrqpgoazgtqcqkluhjlxqamxjmrynkmmuvwomcbsbothcow"	["dugz", "levd", "zzlw", "foam", "xjxk", "aros", "hewy", "qzqf", "tsdi", "xqbi", "fnqf", "uoki", "hrjs", "idhb", "wvwo", "lozi", "getj", "nchn"]	[935]	TODO
"phjzamyhsftaazyxzitaxamgkjjqoqvsdobfapsdemwnqcqjzseddpvjwoyibufswdeojqtmtxysqazyddoojlvlkeeehdqpxwgaztzengqgajyuomwyjgfjbdmtxlmzxmxyzhpfhcfxznzdypocphixxosfkdlqxsamzhkcjuokxdjtzvlboezbwwmwszhobeptltvfrnbbztgnjlqdgysicdlkcbrbykgzvtalycqglqnesgncmpzyzuyzdmvoythuhbgrbxorbcfxgeoagduipppjiyvcbuenhuslzqnvqusqiqljvrsynaqwftfdcjjhliwxjbnyjpacnjiddfxhqunzgegrvyyhckviedctwvvbxqkpiqwdwegwjqzomcmdcfcxcgnzadvkvypxaxarzljnnsgjkaosgxrgeczsyqsumazzsxzbkkelpbftkjmgmagpvwluhvjozkdbrcmrksntouhraoowsqxdhcpgawexblhzlezaruhujgbexzyrylmothojnzmxeqycbgtzfumpecgwfyjkfrgqyeyimudpzelmudgypvwgmwigcnsfcczhuggnudtdpdbrxwdkgcgvfzvffmmbdgnnqpazzjrerffxanqlpqieyrhntoobekewtsaeitiiqtdnvtmypqazebukizbafjgozlfphpuvhphumxtzuhlinqwbjvgloqchnfbwohcawyscaaigebirfpwlywdvimobkzaqctlzftzgiscaojlhwowsygdrdazdxqvenjyxbgutsbiqlbdozcrkcmrmzixyystziwmvwnzbqswnocrdkxycldyurlldvyrrcvawdxmvordfgvkgpjkmoynxfvpcengxhlhogelxezybrjunkujqlwuqggrbkqijkcdsuioipvtnqctqbbxrmiomhusizwsbzyumkwqtgpyqnweomwuelwswvttgxabyehuokfkkeyrrsuujvjvjsmpdwmddbkoyhztiavikxjroludzlfnmsvefunndlrewiklxveqpaosyiykxsnnljoxlcgipqmxdygtebsrrcgyjyymhwybpvzvajqdmapxfpsdopaxlaafbeslyiqioyxsguidgupzqacedmwizqavwdjsqyzbqyoxnytknmfkwbokchffdgrkvhsprwrocxuplrtmmohczaszebalbtlkevafgpjrcanppvihlgyevjdntwvcqicwotaeyxedkozttnbdnpldbwzrlogpyruttksbxqsqebngeoyggfvfaowjuiwpjmyemihthjpttttcnbrsmaeflmngrxphnztjpfewlrqdlsyvedmpupeqhoqywkoefkmeusygkamtmxjplqaqccxjqfgzfedaqbnfojwoeckpezarjjoihbcdmrrkevdwghvocqbxoerwypzqbjylphzidhzlxreoynfdcdlxpphivkhkjotbvotumeqpubglefix"	["wszhobeptltvfrnbbztgn", "jlqdgysicdlkcbrbykgzv", "talycqglqnesgncmpzyzu", "yzdmvoythuhbgrbxorbcf", "xgeoagduipppjiyvcbuen", "huslzqnvqusqiqljvrsyn", "aqwftfdcjjhliwxjbnyjp", "acnjiddfxhqunzgegrvyy", "hckviedctwvvbxqkpiqwd", "wegwjqzomcmdcfcxcgnza", "dvkvypxaxarzljnnsgjka", "osgxrgeczsyqsumazzsxz", "bkkelpbftkjmgmagpvwlu", "hvjozkdbrcmrksntouhra", "oowsqxdhcpgawexblhzle", "zaruhujgbexzyrylmotho", "jnzmxeqycbgtzfumpecgw", "fyjkfrgqyeyimudpzelmu", "dgypvwgmwigcnsfcczhug", "gnudtdpdbrxwdkgcgvfzv", "ffmmbdgnnqpazzjrerffx", "anqlpqieyrhntoobekewt", "saeitiiqtdnvtmypqazeb", "ukizbafjgozlfphpuvhph", "umxtzuhlinqwbjvgloqch", "nfbwohcawyscaaigebirf"]	[187]	TODO
"olphrsipkemmiurfmytrdzinmoqgfyuclqwquhkczvlrlhonidzsulflllndlhvxuqcrudtvxypqhuycvzdyjerkudtpjxknpdbxgdbdzealrxduknplktsfujvchnxyxliboaufztzwsuchsiqxhgywgvnzkobijasomzcrcgrdszyqrqceocvvskhrjsnyidjznpyhrhymsldxeqtgjqwrvrigqwndfcuxiunnocwypfixyhdkcdxsjuuiuakxbcnsxrzazpxngfbgwfcnmofmuizrutevnrcwimasagffrualhbcpbqrmdkciordemgvpwcossutxhlvnjshzgehxnouesvyuonxbhxkqwoprkapkiyotersssbphhbosqhyuekkvkbulkxsqikioxvkmhdpnnudjbzfvoptwegsnbiyaqispbhlrktppvgfqiizalphchqhlfhxsngbgzycttmnmtxbhpfgzqpmckfzpjsoccdlmbzifrtsshwqwuopjusfptvebnmvraufyqjpcwodrtrlelznfjagbcjdaqhvftlfarvolqchxbmzjhqphnrsastgusohkloihvhizwcsdyozhienofprbcpgbuztffxorexyvosxjkkivctiicnaqhfrtvsurguvjtvgzubbposselnopllsvbmqiewukeyygvniymszqxwwvgtscyqktdmhiqbqwbvmxjpqvwrzaldpnfbrfhiujptxsfclukntsqanxqqnerhsbsmnmprqmlfnbqpmvhinfcrwkegufzpnwrsmtqdxegomtuoqoajubsuodlnmwiktehhqflprnucghebhdzbcygedckaughejntiawsvnplskuwxmbrkbcccxzbthlvapxuwapqteejnsjouzscfdqxlssyqxgcjdajkyqoewtssoydpsvvwzbkjykmqeyiximiibxbdawolyptasisyarkaignbnwrwinisbajystaackmbvnbczjbleqwsmrlpdmwncofbbtsvjeivsrkwajypiybzajeygeclgxjxalzaplpbidbuptxswaosrgacktzesttvycpzbmcaaebyvlamqrundbhzfsitjrxkoktpenjbkzbejloihgwjqazyiloqihmamhjozjzwduvzdmsywkkiioipkxsmcnuytfjdczfvvrhxnqxggmzoiafqnbdrvvhxlilprdafovwvtxyvpziljkvctxzxpsutvfcuebigxxyanycizymtltgwaiijvjbwcvuaiwpfapobperncngpgypfqyctjebpymjqifyuvovaeftsaiozquvzprcdfvvzwvsirsypsvoplbbqrzsuvfqsokocummuouoldozwmdcnfewoxsgztowdyoguxtranrqxkaxgyjyfgynbrluljutlnmftiwstlnaadgddvtejtktlrnaassxpekcojbzkqjirnlokwgsznjjzehjdqqvwmsovyfnqdtuqwnmtkeduuzqlymbvbivaeicelrwbserklcyshdzbuajuuoyexvpbbvmofqzzwwtyftsjfjthrbotzjqrgsjxnvahtjlbywbdtkpuynoxvtsibggxueuhwtnboccjfepecgaflrynkswtfmriobnbflpcdmcmwijnbhxovqeggvmabcnzvrprxmblovn"	["skuwxmbrkbcccxzbthlvapxuwap", "qteejnsjouzscfdqxlssyqxgcjd", "ajkyqoewtssoydpsvvwzbkjykmq", "eyiximiibxbdawolyptasisyark", "aignbnwrwinisbajystaackmbvn", "bczjbleqwsmrlpdmwncofbbtsvj", "eivsrkwajypiybzajeygeclgxjx", "alzaplpbidbuptxswaosrgacktz", "esttvycpzbmcaaebyvlamqrundb", "hzfsitjrxkoktpenjbkzbejloih", "gwjqazyiloqihmamhjozjzwduvz", "dmsywkkiioipkxsmcnuytfjdczf", "vvrhxnqxggmzoiafqnbdrvvhxli", "lprdafovwvtxyvpziljkvctxzxp", "sutvfcuebigxxyanycizymtltgw", "aiijvjbwcvuaiwpfapobperncng", "pgypfqyctjebpymjqifyuvovaef", "tsaiozquvzprcdfvvzwvsirsyps", "voplbbqrzsuvfqsokocummuouol", "dozwmdcnfewoxsgztowdyoguxtr", "anrqxkaxgyjyfgynbrluljutlnm", "ftiwstlnaadgddvtejtktlrnaas", "sxpekcojbzkqjirnlokwgsznjjz", "ehjdqqvwmsovyfnqdtuqwnmtked", "uuzqlymbvbivaeicelrwbserklc"]	[873]	TODO
"hejhbksorrbepdwggrsmcvikzcmafafhbmxmdvvrwnmuutphnowuzubusspsvifcbbowczsivfmltxibqnioqecwkrrotmfmslytgaoygvuoumtwoobklwrcqwfibebzjvltsjphwriviougoivruxjxfmftmalicjfqppnsahlnhcpivqtmmskrnsujhfgjlzkgythmdpjhhgqbmvszeabnvwfbzwyxcgobjvujtdpdgfwbrvdvubjllmswyzltnlrlglrolbeabwjcsjjtypykxwphciuualndrmevkesixdviozduqytvmdweiindgcuyondunshgqakkfkbygrdbmwtbuawppifipnhryxyioxjlikskesihrfulaizukghlzxilljarytvoieuguhqemwlqcaxtecsizmawhfqebeoefdgcmluzbfoaxqraadcfoigipmidjwemzwextnnvnekgyddvccrfhyztnuxevbhsjppsmvfjisxosgvtixbbpemrukvjgacxcmpeavrulscchrwxsorljivnmalbldldjzetsrgnnpsrarsvvniwpyiwraehzmmbtjvipspvolgtvhftrzowowepdexzhsocdprpjxxhtfnfvcxgvqnzrnyjdvbmetfefhpmcciwnhzjmexasandwtlznqbfpxficvaqmcromqhvqckwiyikpahvmuhxgvnhxifkvhczclsbnbepigmqdidmmhqxatcloucioyufsxayraladrhdxrlygupfzmoaoncotqlivbjalrllzpeebjqfdodzmodrdkpxwifudmpozwrcsmuzixivbiyuztfiwifekfkqjmkbqfzwrvcxnhcxbtpehigkyzsggbmbudmxfternuucoqiyiqyqerzyxrrocitsiuhvghwiovrmfxupradrqzdvqjzaafpckxrvustcokflzcwxiwulcugafclwuizqftdkibqwgyxuxfgfgvlplanjgdqhilfpydojayxezmudrvfqxofybckecgrrahxvmqisifsurauickezkolincikptonnbrohxsqbxxcjgrfhviezwgpzclyajtzsuafgpqluvdeqmdnavfcuwmmzhdngximgnmdrnelmnoujfktpswmvtptdhbzufxpckrjqrmkmvqipzdtrwcgjmoogygpqetakuqzouhvmnbwibmbofehjjhtusdauaetzseaxpskvzhqoghmzhibgqmhwlshbkceadalppdbkjhuxwdekvbreswwcvyajtabxosciswlcyfwrfwfplrpuqssdarelyqyswajrovluhxemoewjrsedxydondjqqkgrixgznarjjhihhciabzgrlihopzkomrrbutfyrhcpwrakodiypcnwhmaxxpqkadiitzjutfmjjsfhsvnejcxielfxzbpfbqpmowoygvutekuyoykrxpxazwjcjzkkjmdrtenlvkyhtaetvkncmggbfxgmernmznilnpmjlugyzgzyvvxgsfekbzntqckjsrmqazkqvrgyyczfrdwdfgstnyptxlkiidedzcqtjopunyclyvoskkgswyglcrghrwmxpkmznxvkpldlgonrupeilganbfrkgizurtrlmadxqntldbikcirekqfgtmhjwtdsrmcgqk"	["pnsahlnhcpivqtmmskrnsu", "jhfgjlzkgythmdpjhhgqbm", "vszeabnvwfbzwyxcgobjvu", "jtdpdgfwbrvdvubjllmswy", "zltnlrlglrolbeabwjcsjj", "typykxwphciuualndrmevk", "esixdviozduqytvmdweiin", "dgcuyondunshgqakkfkbyg", "rdbmwtbuawppifipnhryxy", "ioxjlikskesihrfulaizuk", "ghlzxilljarytvoieuguhq", "emwlqcaxtecsizmawhfqeb", "eoefdgcmluzbfoaxqraadc", "foigipmidjwemzwextnnvn", "ekgyddvccrfhyztnuxevbh", "sjppsmvfjisxosgvtixbbp", "emrukvjgacxcmpeavrulsc", "chrwxsorljivnmalbldldj", "zetsrgnnpsrarsvvniwpyi", "wraehzmmbtjvipspvolgtv"]	[165]	TODO
"gowlnufiupkugpfdacnpgiwkabwayzligqvxacrfzxkkxvuumhubwkyjyhngjwalyitmemrmmqomrchxjrlnqutfgwdlnbrronpalihfoavfbswaiprdwkbdgigzeagarvjhwcizbjucmjqpmodebiwhjdkcbcqgnkqvurhqzecycljynpimibcpiuzvxzujwplyrkfecutozpckueicnhcsvrrghttitrzkbaztyrkaiwhdiwgsvkuwqtongnufqxoxagojapgtwxebusxdmuzjbhthblixcfzbcvfzoircrwityinvlfbdtruoglvfshucqndosjndeundlckruwmzlegjjsgngofepxaujvccdfvrulwaqvqcsesnvrluysowptkjmuusmorhhloghikeanbtqccycnhzytaebjofzjdmakcvpwaavsxvlctifwenqiqzxiacblupyxoyudnitjyvspffftdyniamkfajajmjjxgndlaewnaynmhdayqezuxymugghcticfagafqjdwgwgxzrabwpqsykatlveojmzglsczkgqldelvuxhkphhjlvqoavjgzaqtatoefikxwaekupowhpnjohqlqfkbkjiepjukxmywvdgddwbwfjhbcgdlipismkvkiddiabloimnnrjvcostgehffgbjljbyxvzrilnmhlclnahfcvqfahgkqmrzoeuospycliukgxybsdylfapnogdizmevziaqindepzbvcaelliiuztggyfyaidognlhayyojsvzlimigpkozswnknrgpkuvdqqlfaggfpkpiitydscvwpbvmgphcwqvapknyzznzfgrqycikofgraupishgygumgntdkiwwqotxbvoyfztlslbcxkfuzmemlksuqyfpbpxcvoqcvdorrekgzoocqaatewlghavkavutaavibwjhtrbrjrkjdeuydqtaujgflvqpdeortbphvqubvgwkxfrojnlkijoezrrvayazwwmcynodxzuxaoonpnddinjrxzaapjsfhmqdlinlehdoakqactbnuwsuqajsgkjqtkiosuneruydgfbyxtiuqdfxbeqmbjnripyiurfithhfokhoswcqzpqcrqygkvaqvjddxxhdkzxpwmofenjhgkyajhrrqtrrpjmpwcdgoogzswwoohpudjjsdxrtiwkieidienaysipubwieotinpxhtluggklwcvzhpkrymkjnwnaipzjgzjbiuxurkqtueigrqaljhutrgzjvdouobxfpxnrfmkjxslgppjmhhwsxpngcprhqetqhyvtoxuvqbupqhhhlvvtoxjhpzzqmiqzzrvggduevyeroqphevwyvgovkvvdyeoaufiobcueqiurossyrjmutqduvkcllnbxroogncqmga"	["giwkabwayzligqvxacrfzx", "kkxvuumhubwkyjyhngjwal", "yitmemrmmqomrchxjrlnqu", "tfgwdlnbrronpalihfoavf", "bswaiprdwkbdgigzeagarv", "jhwcizbjucmjqpmodebiwh", "jdkcbcqgnkqvurhqzecycl", "jynpimibcpiuzvxzujwply", "rkfecutozpckueicnhcsvr", "rghttitrzkbaztyrkaiwhd", "iwgsvkuwqtongnufqxoxag", "ojapgtwxebusxdmuzjbhth", "blixcfzbcvfzoircrwityi", "nvlfbdtruoglvfshucqndo", "sjndeundlckruwmzlegjjs", "gngofepxaujvccdfvrulwa", "qvqcsesnvrluysowptkjmu", "usmorhhloghikeanbtqccy", "cnhzytaebjofzjdmakcvpw", "aavsxvlctifwenqiqzxiac", "blupyxoyudnitjyvspffft"]	[20]	TODO
"ctjrbovvysppuwapwugmzbdxargctqlhgvqgkxsbtdewosqwjzakzijtcbnnkgsajybhvsuzxecxddmziwsnzguwxyuctcromiyhbyilhepjnztwchpwrprnnkzbunoxwnrtasnmddkarxnordwcngzaluazsabhxrqqeochdozwivbjetgymyzqntslysxvecxkmweiemxfymqujmntiigwzedryvcohewxkqnrdkdcshaxggjndbhvtjaporudxwkciepevnjbjvmwjthmtyyizzffnikkxzodmphydaozufaalxtyipkyzarvbzmxpzvzxtfrdrdjsigihmqtageebigbyumnfyiupskybuzngowrmvxwjakjolnslrluqputjkpdvlmaxshbbgtjugfuovsxcrzyvzppseyuafawwmqwhryojiyccmtvhsettqvutehdxmylbbspfchebddcipprjbxukjugsytviwngwlilvvavexpgzucvbttvywjcphhfusywvkjamiylyhpinclohnqjuhgbskfsoryvzlyeusanaltxvsfwlahzzkztxupfkhcdfmniixtpwifiwyxcfrqhljqpswzputyfsanbqpekgxmzibwygrdupupjbxsbsmffkrzivmaabwexkvvcmeclbsrwkbkomjrsuywvfjhmhpuqrvdygfggtjlgjyrvzcexzqjuyaxdjxhujadeekzkuwaaohofzuobwcppvzspuloakdsrbrluxkagqzycxssafdcsvijtujyqzczzoqfiiedzaltbihjdsrxujktaheyijghczveognxuxaeymsckwtkyggmrmijtdmoiyuktncwrrkqnuywwprofdfdvnfzlogusgkutyextvcbvlwfazfwrnymjverkxkbhfubrelxfvmsncqftmzxggbwaegolcoxbymgpehgffetwvcvytjkldgkndwxxphlogohmnkotiqvanlfukjzuesnhhkrhqyyayjwjueyitqoudipbembwrnbtwfwrkohwcudcecuvyhvlvrlryczwxziahzhtgdvedwdyssqccgtujyrlxdsuieatmzfprdwwyhoacbkizzikgadngxydlfotufkkqribkraofokhgmesknlcrxguhvwhsrwyczyuymykfqedstmobqmiahvxkfrojxygpcrykqbavtfuiougexdcfeqjxzctbxmptohgbopiqgimgvuznjttngokymxyppokhdlusaioecxfpghdqwpoxhkvxctzjqjauvajyocuceiamvfcixayghtnafrimubmvavtaowkumhxdvqtdyewdkhfakdtvdszfuseyyvhitrqzmgkfxrksvcixgljtvvcruswybukkigjonogrvlbztfbaudyrezlbvcovjqmelruivrszysewwejwhmgueobrcparwqisziqsjytlmrcjfidrokruwgrnihexpxqxyvkzqzecddgtqkmbfhblkrgmtzbkbtdyzufcfxivvnzfpezxomewnfabpcvphehfpvbzdxnbkvfvrujvxsiikpitjckmjeudibremeqsgausljupfigarsypfbzwqzoxatatrsosfofuafpesgspqaumjmanelissooejhdqdqefmexkzkrankwxnnvhicleamwighzkemajcquwfkjkmns"	["deekzkuwaaohofzuobwcpp", "vzspuloakdsrbrluxkagqz", "ycxssafdcsvijtujyqzczz", "oqfiiedzaltbihjdsrxujk", "taheyijghczveognxuxaey", "msckwtkyggmrmijtdmoiyu", "ktncwrrkqnuywwprofdfdv", "nfzlogusgkutyextvcbvlw", "fazfwrnymjverkxkbhfubr", "elxfvmsncqftmzxggbwaeg", "olcoxbymgpehgffetwvcvy", "tjkldgkndwxxphlogohmnk", "otiqvanlfukjzuesnhhkrh", "qyyayjwjueyitqoudipbem", "bwrnbtwfwrkohwcudcecuv", "yhvlvrlryczwxziahzhtgd", "vedwdyssqccgtujyrlxdsu", "ieatmzfprdwwyhoacbkizz", "ikgadngxydlfotufkkqrib", "kraofokhgmesknlcrxguhv", "whsrwyczyuymykfqedstmo"]	[730]	TODO
"cqcvzxsghoodkbbrtrywzoiundsejziuyojmuqpzfpzywrfgpnvcbkwzmjinptvbalqhmxdhizpuvlmfdognkcfslchizrpjtxaxrazcjcanawtaurcnhbhsngwfwitqnnowczswklcjyihzdbrptberktgguesejtaxnjpfvnsypeiqbexyjapfbwtmzjdpytourfkhaaqvahpdfoytxnooewmiyihfucisqzvebfdcnprzrbnzsgtmcazhlmlyeqvbymguhbwwtsnocitiqgtbyluagcsngtixapcittuglvpxmvlrnhluzyhyhdxasnhnsbpjykmwifhzhamtojqauukkuglqmsktycrfvekmpcwuzjqtdxnuyfgztmywaoqscjcyumdmotgzfsnhbkzuyybsdjgzjslufuzilktljrhtotmqxaoaiflmsmwharkvsxipguzisdlttjcfyevopjkyblgcafynkezpxjcnjacfyfupplpwvrsgarubjwspallpeatxqislyqijiyekpkrmetfjgckcwgnayhplcyvhlkabmsyfxpyaenhgudurnvmurrdfpvlzihckvpdxuhfwanchlwboafnknncsjalqiwrsmrnjnaccrrpaitwlveggjurdrtqcquiptpkrdvffhuoefuuhxvxylsyzjlsidthsdvodoypcahhvztyqzsnfuwocytdygrigysnyvtpwvnwthzcoxxfrhrfqohgbnfkwcqzdceteuqzzykzajvkareorqqlzwpbtxytwfnzsznxkqqjkbpjlggwzshjjjiycemspqlycdtvbdnrnswvfeavmijqbgnlngpszimmmaiqzpjryrybpibyzknchoatqdjyindkciymhxeqshteyeriixdylakiabejidbdonmcddjihriphchywrfhkyynjyvqyqgyzphsfwwlsuidxdhprguvltjdkngdszyxdpnfvcskwwkpwewinysdkqdtsnturmhrfxnhahepmoxjvhqggrnpnlvhozkcxdpmxtyfvruochjdgkjkvmcjndzbkujjxzqflnnuxejzfvztsflzyufwwvdlujohpqnikojgvohpmmoaylnqyzvzsvhqlhxslvwqmcsmcvrdorzytfjkvnlsgsrmvtzuanowxslaztztolkwzbgzsvxrzzysnigrpqzocfumobxkinlwsmnxidkakmnhkknyhrepnaynvsqmpsxcacajrjyonxhhjwqwzbvrvrxdmivfwlqbaemsjesmwvrcxjsqitukirmkcidtngyygvmodamtwdspuxwgprpygfmjevfubqazpwzbbxeeakppjmwzyvkjrsdpzhkclliiyahlqfuvykpusmpoorjcdjbzahifsscvnpjtxvzaidpxvwlizvozlqlyxbnnyjgukkqnidctdnpoeiismsubryukjvfalxpbjusquodwbqwgfjhcpklnoepjcxywrgvtdkcuzyhcnkuzfkklwgdwlbcumhfywpswcihkvgvjhlrlpecvgyuvjwxbiknjcprrhbeykdaejmukmasbsqgfmouzzepiqldlkcttcgzupqnfvrakjdenoafzslxcvwwitgwisqndtiqadojldx"	["mijqbgnlngpszimmmaiqzpjryryb", "pibyzknchoatqdjyindkciymhxeq", "shteyeriixdylakiabejidbdonmc", "ddjihriphchywrfhkyynjyvqyqgy", "zphsfwwlsuidxdhprguvltjdkngd", "szyxdpnfvcskwwkpwewinysdkqdt", "snturmhrfxnhahepmoxjvhqggrnp", "nlvhozkcxdpmxtyfvruochjdgkjk", "vmcjndzbkujjxzqflnnuxejzfvzt", "sflzyufwwvdlujohpqnikojgvohp", "mmoaylnqyzvzsvhqlhxslvwqmcsm", "cvrdorzytfjkvnlsgsrmvtzuanow", "xslaztztolkwzbgzsvxrzzysnigr", "pqzocfumobxkinlwsmnxidkakmnh", "kknyhrepnaynvsqmpsxcacajrjyo", "nxhhjwqwzbvrvrxdmivfwlqbaems", "jesmwvrcxjsqitukirmkcidtngyy", "gvmodamtwdspuxwgprpygfmjevfu", "bqazpwzbbxeeakppjmwzyvkjrsdp", "zhkclliiyahlqfuvykpusmpoorjc", "djbzahifsscvnpjtxvzaidpxvwli", "zvozlqlyxbnnyjgukkqnidctdnpo", "eiismsubryukjvfalxpbjusquodw", "bqwgfjhcpklnoepjcxywrgvtdkcu"]	[843]	TODO
"abisdabzyavxypmdkfpqbpqlhqxsqrekrfuyjnnaxlbpeyglbccdzvawugeanvighdlerdxciqyxklzjuytvcosqzkkxwaxmoovnghwizopanaaphobsynlrhmcmndfqghygkolazehwswvcdwvaicfwrvcpxtxvypvmccslspozbjltxzgjyfwthddiwfgcxbrbgpyfzldcmijghjgtqvfcxhhuahqblodhaczhngstmutvutfaqmrhtbgolqpttbypprsunzljvivrcefbtclxglvhotybxfjwcslxdvffgrcibdaxkuegkzuppbjvnksxukehwcadumznzliikxijkdpgwkdmghgqnhcmqmiawetbtpcvtrxvyttobqebahfxpdcxilgkdtbqjohwfiukorokohjepqoonyvwqdwsqxisdvrhcpuahfifzigabayehzzagkvxqclsbdogbfyrmnohdzxwrkzjceailojoalqoitacnhqtowejkzwrabrrlfqxvsdkjfzinlhpbcjpdektuwmvxwaohddirtirrexgtipxlovautocfrbriosxgrknmagwqvvhgbilpoffjwtfixphdxajzzrhrrmoizuicvfybibbpxslhwdercmqltzviuduvhbbmszybcikbdersiboravvgjuluhkmgdylruflqkeqtvohpguuymlemktjhvmhqfbzzfnbsbfhxtjtbulzbvfyvnimmudpivahetekxgnhtryxkwkjnqmyafqsiuxnmbkvvrtnumkrtlidzytqjapatxvpmhffhxeicytwsbaeiryexzcxlijikvlylogtvhckvkwrdjdzlcfclttvotgcfrhknhdypkytgomjgzzrldfxxruvlukkorgsjdkpbmjjeidhrpbdbnqqganldhejjhsjmukidbimazvfawsaiijlnhvrjyldwkvosteuvxdgdwxzhyrtslzatgfdygxppsaxhqiylayyjprhldygmrachdptjddpncwkdomalqnywgwzkczyfhhzeugmejrboijgmyiqjtgqbdtdpocqufdjzdmfvwnjprkhxyawzmepzmjyecjgwvjkfmsncznzfufebdacixahgawhmqhzhhczvtwkklcqkdzbvlggpyhcuaskdcceqisrcmecwfdwugfmexmnodwfpmskuveacpwiralabijrmfwvecmhkpaordopqhyvnoggyhaavcfothbisyxsekwbdtknliljmrkqbzdqesdaptrxoiyuacrcjexexpmgnlvhfxigyoyebtcpphsmsohfnigamembvolhdsuzwtfxfwwwmeobnfnodsyigqcdwsexzjdjtuxuehyxjrqncysgdkmjfhdhpizyioyofgfgubxhreouwqfsfkfynhwutbbppycqytxbthrijnvqarlbhkzkrksmjhekwsqorrpiknhggmwytoayplisrbblelrakzeeqrxfgifpueehustxpzyhpibnxmtqhaccxtdtpudqgmasjpykyfnmjhdftwllghsxlrsepnzodrqvhgtwxezfdolwtxctavsuaapmxyeuxceyaaobqiuumkycqhjdifnntfdnbmzshujqdpqnyycfirtbbddihlwlksjjjoshwuaqsdzjceflthyveaodudysnanneokcfyvycgiyedxyepzviixdokrxyjaqcyvtufcwxrocythvjfuabyppmnwsnpixeoujvwwnidfswolqtjdxygtssqyoxnbzxnzhibkuwqcudniqrzrxzmlwkfjwibbjephxpuidalrpjwvlbyczfskqykrndenmuggsumrtxdkfstosc"	["anaaphobsynlrhmcmndfqghygko", "lazehwswvcdwvaicfwrvcpxtxvy", "pvmccslspozbjltxzgjyfwthddi", "wfgcxbrbgpyfzldcmijghjgtqvf", "cxhhuahqblodhaczhngstmutvut", "faqmrhtbgolqpttbypprsunzljv", "ivrcefbtclxglvhotybxfjwcslx", "dvffgrcibdaxkuegkzuppbjvnks", "xukehwcadumznzliikxijkdpgwk", "dmghgqnhcmqmiawetbtpcvtrxvy", "ttobqebahfxpdcxilgkdtbqjohw", "fiukorokohjepqoonyvwqdwsqxi", "sdvrhcpuahfifzigabayehzzagk", "vxqclsbdogbfyrmnohdzxwrkzjc", "eailojoalqoitacnhqtowejkzwr", "abrrlfqxvsdkjfzinlhpbcjpdek", "tuwmvxwaohddirtirrexgtipxlo", "vautocfrbriosxgrknmagwqvvhg", "bilpoffjwtfixphdxajzzrhrrmo", "izuicvfybibbpxslhwdercmqltz", "viuduvhbbmszybcikbdersibora", "vvgjuluhkmgdylruflqkeqtvohp", "guuymlemktjhvmhqfbzzfnbsbfh", "xtjtbulzbvfyvnimmudpivahete", "kxgnhtryxkwkjnqmyafqsiuxnmb", "kvvrtnumkrtlidzytqjapatxvpm", "hffhxeicytwsbaeiryexzcxliji", "kvlylogtvhckvkwrdjdzlcfcltt", "votgcfrhknhdypkytgomjgzzrld"]	[107]	TODO
"cdabghmxelbriqoxhxvdjopjfsggoydtxphkjxcuvhngcdurxwrcyhosyqmwuavqizehygjqcptxjfztwixerutbvbiwygajnyeraxpvcnsnnqtsmvcfsyklsdxvglxgusacftdqtrgqxwahtbnpijbujrwfxfhqikrtfryqjussdorsesnqdjzbqtvkqffxatbmkcjwzgbzhctnxcluoomlcizyqvhehervghcnlhfitlcbssywioxurmgxilwrnvqgbrhnwdcplwmaeddghxvwhznrosbdqngnicnvclyypnhxdhuhpymbrmlszfwdfxoqbfoglwxewpsmvoarwglvasqmiaxqlawdxrgjzuxsieedfyyruklcorkiotxczncwriginjjcuucmdpzkrhzrmxjyzipjceqkqrdghjijiairildptzojmvcwhngsvrodjggebwugnzyihanrwolnerszixtgzsgpwixqkgtkobogsombnuvedlkipnmmtpqpfkzpzcseororwycwhnthgoyjooicuxfuczclhudgdoywypfaklkeqquqlzyemrwvckzsizwreebtxvzqnpogbutnxjvolcjwzpjcmgusfypmqxkgcjqoryfoljnsovjzrwlnmjtylzfiypyprpjbluvswbprusinjyztlqkrlpjpiqrjzhmopsiggoakiekhspiabdffpkafefkkdtjjaoepdriitdwkpkcyvqwwedrvohwoicjequxcdzaszooxjtdmmmnwuilasupkbwahohsofnibfrrjkrtqftamxvhnwvuilqwgijlcpmhpfwwuejvjnrcyqsyphlftriwphxejhzwotbalmrzwbhfdyrpamabefqyovrvzilepoyvyzufjjbjccrvkoxazvdemyarjvtsjbqcjegyaolvqauzxgwmzmrwodejvqgansvjqzlberuooqfxrwhinwknmujsvzzvcuyyxkcsdbwoorasekkbqsjpfmnjsbyumodopcwpgzkhcsyhogfcmkzmlzqykjhcklqirpoxmjpbdhfgcbivycipgmhetqdfwttefcsyfncdhqgtdyhxkrlvfialxpgfzsjeudimnamovpieqyrebmavvqnibdtjwoaohfygydhtjygznykboixexyqrxwgfyjzxurkdrjrqcxdldbfohmzkoddmxgydbiuyktaghfttwrmwlyytnwoowdmogfdoiuwnzngffycibvvociickiqlrpcxpcmfzofbfovfmotsjgiorkqgdrirhmzkvyppwxmrutt"	["mxvhnwvuilqwgijlcpmhp", "ooxjtdmmmnwuilasupkbw", "injjcuucmdpzkrhzrmxjy", "iwphxejhzwotbalmrzwbh", "pjpiqrjzhmopsiggoakie", "fdyrpamabefqyovrvzile", "luvswbprusinjyztlqkrl", "jaoepdriitdwkpkcyvqww", "yjooicuxfuczclhudgdoy", "vdemyarjvtsjbqcjegyao", "zrwlnmjtylzfiypyprpjb", "lvqauzxgwmzmrwodejvqg", "ahohsofnibfrrjkrtqfta", "kzpzcseororwycwhnthgo", "zixtgzsgpwixqkgtkobog", "ckzsizwreebtxvzqnpogb", "khspiabdffpkafefkkdtj", "pmqxkgcjqoryfoljnsovj", "gebwugnzyihanrwolners", "fwwuejvjnrcyqsyphlftr", "nwknmujsvzzvcuyyxkcsd", "ldptzojmvcwhngsvrodjg", "zipjceqkqrdghjijiairi", "ansvjqzlberuooqfxrwhi", "sombnuvedlkipnmmtpqpf", "wypfaklkeqquqlzyemrwv", "poyvyzufjjbjccrvkoxaz", "utnxjvolcjwzpjcmgusfy", "edrvohwoicjequxcdzasz"]	[391]	TODO
"lkqscueldrtjftifwxvixctmnmgcyypuguvwmitumjdjeqcxdslhxbsbqkzkgzapdowqaaihzqagrtzwfznchvxzmclemveufyiuqexbjzsvrgdxxlmjoawldweubtmlrkqfnslblmegeqoaqlobabbbxnaiahhpbfzagusajqlhmzgzfopqhtvagzrlvegmayivbtziazmrdeorrvymewikkmihdhbkxnihgaelucppyohzfxljsphnmeyqdrvmqgkwvwtwatwfmfdxtsfyszewgvhbvlcwlylvesbryjxvnhyatsnypzirfsbqmjgmwapfkdxlkqoxycuromzvlvvqimidghnnrqekapmiuplknnssyrmyapmrkswsclvwqpochpfypqguhkjjbrcsrybspjfcjwgdqzvyowbxhbbkqeplbcmdhqzmdbumjfndbdpiadlpybksqkmvxbmavlrmszbhsvcyetoijziwgdjnfgdcduskqtwjrvatzbrlovrufkryyamslqxkepqxwpquvcguoruqgzhuleeymcgrrzssojpkauvjhjwvlrcaxunxozdaetlshsqlmfkrshlbldkvtyomksgrrtpbopulsevcorqiiqcraflbdzqqrnymvywzyhulscciqrsfuzxntxjocdbqlrzvzenddmdzuvvmaioqjurkslpodtdkcihibuqxxatdxknzddkkpbqdkqhqpcvnflzaqkfdehzpbszxzglyswpurmeryrnklsewwajxlqzkatlqdlsztskcwcninhccdfgawvuttdzbjzvefiarweqpyihmenyumfwfqihgqvsbninebtbofjxslanmwmxfvsbtctdgefsojoriebljeymifyshjhxxbiijwcoxihualfpiplpeyksdafwoxenibulvhoyevkmxaelaigrjetmrhfajadlkpvhmuocchqkrxealmpxdtlwwqbbtxkzjiogzfteylwoxyyfjxdkisyfvrlbvkpydvfichsmgjlowftddounibegcedscdpjmzlyxsaohaqquaga"	["rlvegmayivbtziazmrdeorrvymewi", "yatsnypzirfsbqmjgmwapfkdxlkqo", "mfkrshlbldkvtyomksgrrtpbopuls", "ddmdzuvvmaioqjurkslpodtdkcihi", "ulscciqrsfuzxntxjocdbqlrzvzen", "vatzbrlovrufkryyamslqxkepqxwp", "lzaqkfdehzpbszxzglyswpurmeryr", "xycuromzvlvvqimidghnnrqekapmi", "svcyetoijziwgdjnfgdcduskqtwjr", "quvcguoruqgzhuleeymcgrrzssojp", "evcorqiiqcraflbdzqqrnymvywzyh", "kauvjhjwvlrcaxunxozdaetlshsql", "buqxxatdxknzddkkpbqdkqhqpcvnf", "dbdpiadlpybksqkmvxbmavlrmszbh", "pfypqguhkjjbrcsrybspjfcjwgdqz", "uplknnssyrmyapmrkswsclvwqpoch", "vyowbxhbbkqeplbcmdhqzmdbumjfn", "inhccdfgawvuttdzbjzvefiarweqp", "sfyszewgvhbvlcwlylvesbryjxvnh", "kkmihdhbkxnihgaelucppyohzfxlj", "nklsewwajxlqzkatlqdlsztskcwcn", "sphnmeyqdrvmqgkwvwtwatwfmfdxt", "yihmenyumfwfqihgqvsbninebtbof"]	[186]	TODO
"osegamjlyvhccaprkfmxhnlbamvkcyuclggqxqdwdrtsmvudmfexjwpmoujgzagxbngpljefpqcjdokcfgmgvjfctghpbgqqitlgybrdrsngsyohzfoygsparpoxmqgdyvjqankijfxnazuklpreaawxobwmfbcawrfzwqaxunrvdtuscwzwrngjhlhxtekfsqepytqzvpxfedveixjaswmzqyvykgawtaeofqdmlewbztwtoxsjkvubpggxkekeqgootdfjzkxhegworpjtnazxvdbozccgucnldrfhwbojeajfoinnudscnygqpgwxhlpjzjdnztbxfflfwhjbjulbzvzwenucoyrzcnqfbzlkeqqjtisyfynlndjoatovoryhqoxrzkafvshdwzekbohetdhfmhmmsqypqqbnvrrahdxauihvmcvhjlshebyxstqkxsxiocggrfetqvjoezodxdrifvterfnevrpcziooqhamlxmbvfmyoerzbyfxtrmrorddlddrjmesaiyjwthltsirlqvspyuibqbwifplwnyrzqnpfuogqmddosoiakdqvmmkbjhjwxupgyzzzrsuvuwvjwkmhwcluioevgsqsdcqvzgxcqrvwplychqhwdvbectloprdbzkwvmgecjawvdobqwlmmwupqvuwgqyegrtollelfwdiydnhmoyqwzczxopzwdfvuuvhealxrxtvhvlyeuhtqekhofswcedogfucpexamojyhrqcjjjyrvyriaykwvyamxaqmuzqpuekjruyuadtjlietdkxszpvvcskghviuasamqusztkgdfoyokastcxrveahhjynfavbzhyewromhoqopxdvyespeypvhshzmeiavrqquwhgatgooqcxjfdsblfamxiqyszpgkcnvhptqmtwoqgqutkcrjaeoojxsotdijandovixdcxihgfwixyeukeuayjvcpujoypgkzsbxlufhsuplfucqguffamfoshgvkkujqvorofssrtmhlmjesgxizbicaxvorctnvwtvunmtewqbumajznleeneqrawutfiruhxiuacgsqvqotpsbuxtmmflguhwdpyqkwhxzefhjmqqolkvojdmeopckkqafhzqtfhuysuhvbjcjlltfzhyzkptzefevvrjijtqnljgjiuygecrfcbekgdtohdcekrnliloufgawnoluhmshuzppoepgrnctqndhhdgzqvilegccfshdcibopggapgseigvyjhayvgnlunadjbnrohrioqgptrpoqnymnujgnwviltbrrhojcqlhmciuszuktxsbduetvlhbdvyglxqbgdlfsgsojdpihturlgywvidfulroipvmat"	["dnztbxfflfwhjbjulbzv", "cgucnldrfhwbojeajfoi", "zwenucoyrzcnqfbzlkeq", "gxcqrvwplychqhwdvbec", "yhqoxrzkafvshdwzekbo", "hjwxupgyzzzrsuvuwvjw", "ubpggxkekeqgootdfjzk", "eofqdmlewbztwtoxsjkv", "rzbyfxtrmrorddlddrjm", "obqwlmmwupqvuwgqyegr", "pcziooqhamlxmbvfmyoe", "kmhwcluioevgsqsdcqvz", "yxstqkxsxiocggrfetqv", "tollelfwdiydnhmoyqwz", "hetdhfmhmmsqypqqbnvr", "esaiyjwthltsirlqvspy", "tloprdbzkwvmgecjawvd", "ogqmddosoiakdqvmmkbj", "nnudscnygqpgwxhlpjzj", "rahdxauihvmcvhjlsheb", "xhegworpjtnazxvdbozc", "veixjaswmzqyvykgawta", "qjtisyfynlndjoatovor", "joezodxdrifvterfnevr", "czxopzwdfvuuvhealxrx", "uibqbwifplwnyrzqnpfu"]	[206]	TODO
"klrmrtvyrggsajmtrcjqqwiwbgbqyjekrrwbomvxcrqzieyaobkkhnsfqxnqrsfbtatvixyvhqtnbtfhkplxsuymdjhvgdssxdougosgkdurwndislqkpfwfttjjtgxjhscldfoebkpkbfjahtodcqbqmctusucnljvltlxxmhoedemdwjdbojsjyeosjugraryqyldcamoxanxbmkiuvdafezczmitncsawqavyzlmfvssyzeuweexdnzzrhywtnqpaejmnvntnhdjudahpmmrrptupigcyflorruibxrcxrddraeviajclhhgzgizyjernjwmrcjhxnhhpyfoosbzzquldgvyfqrotauazowretrrsqlrxdwvqgyjmvbgzsierxcsnucsklojezilsdyaheeofuitmyikavnfsdwjkvmgovmpuclvoglxrbjhulgydqviumkfycpwkxafssjpbrknnvzadqmdnkwmcihovyqpakvqzwbomvpfnskiccirifkfallkleewhfxblehiqyaoswpfvojxlvywdmngxzzcwryjfghjgwezrrwzakrwfdrflwdtesqttfymdgrhzfbwqheexptkfarhqvnvcoxqlxylwrxdbrcteoimmpagmglhevfaghhachtuebzujpgumzrnsgqqmpqxujsvujgdqjubwmcegsjtkihzzvopqlgirbcicsihggfstxnjbggqulwayflqeoavhzctkrixhcvisalliaegttitxummyskylwtmcdstcaefjghkwkmfibcutjewxyiowezqellaikhkxlxjxssqaviuitgjtzhrnuziffqaerwxhufmmchslsmzdoacdclsefhfbvljujfvajysdhhhjabnzedzolkoeglbdwcuegtmfsvfjpdmljvquuohptwfzjssypmekumplkvreukxadeeucysqiwwkpplrgldripkjudzckvjefzjguxpgzaan"	["knnvzadqmdnkwmcihovyqpakvqz", "ucsklojezilsdyaheeofuitmyik", "hfxblehiqyaoswpfvojxlvywdmn", "igcyflorruibxrcxrddraeviajc", "eoimmpagmglhevfaghhachtuebz", "sihggfstxnjbggqulwayflqeoav", "rflwdtesqttfymdgrhzfbwqheex", "lhhgzgizyjernjwmrcjhxnhhpyf", "ptkfarhqvnvcoxqlxylwrxdbrct", "avnfsdwjkvmgovmpuclvoglxrbj", "xanxbmkiuvdafezczmitncsawqa", "myskylwtmcdstcaefjghkwkmfib", "vyzlmfvssyzeuweexdnzzrhywtn", "ssqaviuitgjtzhrnuziffqaerwx", "ubwmcegsjtkihzzvopqlgirbcic", "jujfvajysdhhhjabnzedzolkoeg", "wbomvpfnskiccirifkfallkleew", "qpaejmnvntnhdjudahpmmrrptup", "oosbzzquldgvyfqrotauazowret", "hufmmchslsmzdoacdclsefhfbvl", "cutjewxyiowezqellaikhkxlxjx", "wjdbojsjyeosjugraryqyldcamo", "hulgydqviumkfycpwkxafssjpbr", "gxzzcwryjfghjgwezrrwzakrwfd", "hzctkrixhcvisalliaegttitxum", "rrsqlrxdwvqgyjmvbgzsierxcsn", "ujpgumzrnsgqqmpqxujsvujgdqj"]	[176]	TODO
"cdruwxzxnypdkeeloxhqyhmbyjwzgyyuctkgdpggezhxsrdxrhfdrootosgjpkfhwcrpilnotbqodqqfliwqxiwqfdarfgmawcszbawoxyezduptgqpidoxwoabypixrjyfsjbxxjhtdnlzcrxuqapcvsjqvirmexrqxnfxndnvezyfwiacmsdnulpzhsxrcogcptbjtkvywazrlfzjnntdvlnasznjwbyqajokrptbiethlehnbyvrisewayfyjvxsvqvpbhhmabgowofvdxmiyzvjcxibvilytnecbrbttkrpiitihlwkndkfxdvvbnrogjnparukybokmqdgkmdujwajmfnyuwlvkzxhpjxnbajygdqjjfuucyfynmwxffgcjgpkepjksutqmwqpccqxubbxsgtetsflwafxyqqmcpayogvnfjeqiqfujmdxhwltikdfiwkjqvhgacsgbrjpgfqgrwgjcgljdtqsusicrrwzvebqusavnebfxpfotkcnweokrxnhkxcjejonsnioypybotxfuolowrgyocwiaeguemlqdhecnqlpfdaoobesnamfdqdqlybvgsuypzmlwmwojinomitdmlpxqjrrhnurqwxblubffeyfqciajsrmssmtsowfpribihmyeindqawgzvmdqojtxuescxvgqrftjkbezrgfzttegdhjoetqnhzrghmjxkxmiavbzsgecsawsufxzpfgnumseusvccnjdibewkagzdtrmpktkyhuegistukqiuosvdqjpnglgioeeeglkqpjjzstdzpilyuvbovipbhtujitnrdjimugthyzcvasryktxmcpiwjvkghjliuhewqytdbrgxdmspdskahdhhgtqotrxjxgfkqmfzcxnrlosxtzcbvmfbxbdtzddzhwpjfozvqgmojgqtbecqthztweemhgdrzjrpowtvzluxhctfkqbudrxuuepnaupqpcaygkqsrcsxdopfgeqhjqnwmjlcuuzfiftqyfttgothejzoewunstxytljlpdkvwwueaxhmqsvmiysqnipqcpzapdokngmltpvkmboalubheldbhuzmfecrhtgbhnsbxonmzfytqjbmmcigsannurfnwxotetreqwnuorjeayvslrwynjcdrhviyucrmtmrjdsbqswgujkpaanfbfwzdlbsudzpvxstzjruyyzehmdmsvrjjyddsobikrnukrjwrakxxwegfhnzouzbenofptdckgibmiebllajffgadcfriunqtwymucsrfutkninvhfvzbbqoligyvbdeebvndrwwsusqvquoyxkjayoafmjxixhqbbpotoyocmhfazhlvllpioinbenmesawliszxpqcklhgnoesrgvljavywigtupjpehmezrwwqtdwfivikyyolodplgumnufierqyhcnlagfiklqbsddyqdnrytcaxhlvjoohtpekndxjxfyywbusotzlnqozlcyjndehuadt"	["kmboalubheldbhuzmfecrht", "ymucsrfutkninvhfvzbbqol", "rjdsbqswgujkpaanfbfwzdl", "yxkjayoafmjxixhqbbpotoy", "annurfnwxotetreqwnuorje", "iysqnipqcpzapdokngmltpv", "fivikyyolodplgumnufierq", "ayvslrwynjcdrhviyucrmtm", "caxhlvjoohtpekndxjxfyyw", "kqbudrxuuepnaupqpcaygkq", "xwegfhnzouzbenofptdckgi", "txytljlpdkvwwueaxhmqsvm", "bmiebllajffgadcfriunqtw", "yhcnlagfiklqbsddyqdnryt", "bsudzpvxstzjruyyzehmdms", "avywigtupjpehmezrwwqtdw", "igyvbdeebvndrwwsusqvquo", "pjfozvqgmojgqtbecqthztw", "awliszxpqcklhgnoesrgvlj", "gbhnsbxonmzfytqjbmmcigs", "rlosxtzcbvmfbxbdtzddzhw", "srcsxdopfgeqhjqnwmjlcuu", "vrjjyddsobikrnukrjwrakx", "eemhgdrzjrpowtvzluxhctf", "zfiftqyfttgothejzoewuns", "ocmhfazhlvllpioinbenmes"]	[904]	TODO
"taekfjliigflkipjsxoptbbtgsinwurtlzxlkfzhlolspfpwvlooxhafsbnyapfndthfvzfdfjjtefxljlkclgynpuurmrpxqpqmyvqllcivgviqywuoycyuidwxipbvlcjorsugzffxwyedyzxznwjtdajyhuibfofivwbghefwxmiuhkjptveucwcyklprupixpzhqrfnqntxxndjjwubduebqvdqqkvezgeyloufypvulwaqusdidxmuzpngzjthxsyivdyikhfchbuunrftpopyggzqxgqzohnbdvmhvocvhhqxftztbdhpzmzsvytbgbkjyzjhiokipoktjgouzonuyidfakeosbhzkezwilitrumjcdlxtuohrqfapmwuwhavekqpskjcqhpryrphwghwhdgpqgnxghekwleccrbrrfhsfnsrrlurjsxdebvkzbxbtsouyfwsfuzcoqdmffojganqqeosrlnqmgxvgodbmpmdbqqbtbuhqovmiztdtjkbxegfcbjxhfubqxkeivoubbjmuspppmijfaegxwrtwwcqxfstktqyssvdzjvyrrpilcaiibkibfviiiwwkpycrrlbzdoeisozzhoebjpkmjwxowpeokpmurhacnklwevaebwruovbiqippqclnkueuruhovbzgyutovxjbeuegfchvaaeylhcgrcvqoahtstbfmueikhjuyetmkgvclrbgcgiqniowufrewmoteixtmzbbxgohlfazlbghmuwjwruuemqiojwywlpxostkadbqoxqioqooxmmsfsbxqgupomjyvydcaewhypikjxzyshjastdwdhptodrzlixqnnxulkxqmcwvsbcjssjalcyrgdjmgiautfqiweuzqkarszbmturchciggouoqyzzlymlxbqjscamnvczpdoqaphplwshyxzowikxmpikvebbbnwdvekdsutevioitfptdejncozhcuzmebnawmzcjlqsblbcahueobytrqtdxspsxaonkfqaamnqvhrshwvmlhbgtczzzcxcogqjbzvqhjmujmczzrivhzctnosiqrsllrtpeozmifeeoprdofwpedjyxqaexnuroqxdbcqzyswkkrwerwcmfptvbdldqccarkmligtsoxiexiiprlghrdtbgcoibqjlofnpbbrwdievcmmdkuckrwssivbjntvgujhsuwshiqusaelsazibzbxngiduwwctjsigclasdyeetuqdauouggemlpeloqirrslcnpzxwrgpkhkgubsspxkfjalhczfdpagafxdfqbxmbouaripxketgwcaixacjteqvgkvryoopszfynxwz"	["vmlhbgtczzzcxcogqjbzvqhjmujm", "jbeuegfchvaaeylhcgrcvqoahtst", "qzyswkkrwerwcmfptvbdldqccark", "mligtsoxiexiiprlghrdtbgcoibq", "wkpycrrlbzdoeisozzhoebjpkmjw", "czpdoqaphplwshyxzowikxmpikve", "bqoxqioqooxmmsfsbxqgupomjyvy", "bfmueikhjuyetmkgvclrbgcgiqni", "zhcuzmebnawmzcjlqsblbcahueob", "xngiduwwctjsigclasdyeetuqdau", "bbbnwdvekdsutevioitfptdejnco", "bjntvgujhsuwshiqusaelsazibzb", "qmgxvgodbmpmdbqqbtbuhqovmizt", "jlofnpbbrwdievcmmdkuckrwssiv", "muspppmijfaegxwrtwwcqxfstktq", "czzrivhzctnosiqrsllrtpeozmif", "xowpeokpmurhacnklwevaebwruov", "owufrewmoteixtmzbbxgohlfazlb", "biqippqclnkueuruhovbzgyutovx", "dtjkbxegfcbjxhfubqxkeivoubbj", "rzlixqnnxulkxqmcwvsbcjssjalc", "yssvdzjvyrrpilcaiibkibfviiiw", "ghmuwjwruuemqiojwywlpxostkad", "dcaewhypikjxzyshjastdwdhptod", "eeoprdofwpedjyxqaexnuroqxdbc", "rchciggouoqyzzlymlxbqjscamnv", "ytrqtdxspsxaonkfqaamnqvhrshw", "yrgdjmgiautfqiweuzqkarszbmtu"]	[486]	TODO
"oabovqtbmwlmsvduunvpkpklcnqxjmbpcekncikhajcwvilsumshmfuammrmpjgssrcudfeyfhdycofquhrkdtnaqzcqulwqmuilppafhkikdppqalookyqplbnfycsuxjexpctlfqqhnnrahlnjjxpronbwdiabgwpumttntslecmwocbowooncbkmmrtzcihxkwsbvvnppfdblmcnzfnpubmbxxqwmvbzqmxgbaiddlfyslonwkyqsikdmpiprrrvdvkefzhzgdlxpqqwonbeuczktwkonqrwgazjueroviprgjpvnbpiihzqpxynxhbtzjessoeyrfhdfhxmpxpvrhgrzurgejqkxtfcfjewfkfxncsydezjwdvxqemetfgclnicnjmebjdwwvsgongccdwcvzzyobtjwqwbjribvxtqizgvrpnydwsnjnpkdtyftcrtnsgzwxvhukmtbfemvafulmrpqhisodzyvblaofzhvkoxiutcexxbevcefqriwezavizaysizgziydnsrqdjsjwreompcjhkucxeedpohzrxnhczvgrpiqljocpfwavxkisultzuofiobaaqeunjuljzkjbslqcngzispsnwhutpednaxjafrlbaredicuuaddwtiditxqfdkekytnmyavngywbexacoymfzaykzjinbnwwsdltyeevguljfrwvhlkguwvswbctkizflfqaqcmfnsfmproxidtkfnfrwaottalbshywyurpjwmpjzxmqcreswoiodqmkhrfgahvffrtzdfzqswxuqspwfichgaqdgeafkgxzwcemrytodsldvlfkslqavxkwsyvmimwlausivhvjyebrbzaimlforzcyrpudiloetmjndvntkdytqnjfafuionzlndkgpcqtlqeovtfhuuogvopgivyvulgiprkpykfqoanrwgfloitrrewdotnzkicddmdturcrudelhjzqiozdmquvsicgovhekohrxomffnddqnbgyaailedbpvrodgituebgmrnnzcdvdewccyqofbsmlpvpvcmczrawmlwdygjtqbvdwisrrzdihqvtbbzqxibfsfzfjulqaebopialcysypymdwwwbheukqsijqeaaayqqvrrqxopxkgwfreuixbzlidrfvusgzdgcpwdjtcqulopimuotaxwtoqxlmwewgqmgbamgotbjfbinhzevgunzijgkwnsrxqworhrlbxlzyszxykgvhictmqmzxatalzqmmuszmoeumyficjbpgifnfjhtabbuqbkehgkczgxkzszjdxpamfqntvsdxuqlhpbigtxdxleuoygfngdgnwmeaqzlmiiczladkhgyiqzvpbkolmuazbwuyjtuuqxszzixfkqnoizkhacgtxeppzukvprcqizvswmafexgjgvheqshxrxjefooilfgfobhtriloesknpjmpcwxyyxgujzkaovddxyruzmhyxjonqindxqtnhnirvhuamaysjhnushrdhlwrfbpcyedqtqzyrdxbkpuyhivktsekozquxjxnswxhbglxazkjzrnmdurrnbqbalhzrrhonzakcryofdkbjovclenhijnerhkffxumvgzqwlyvyblntmskqtjfcjqphygdnoruutilkrmbxsdwaierjtwctkcodlswnpqvfggvwnqosktwhlnhwbyiterucoqdolxutfwufohacopkjnxkwnhumgdhuwyhynsffvpxlhhbqhcxlwyncavhsnmpbghdmoznlh"	["cyedqtqzyrdxbkpuyhivktseko", "zxykgvhictmqmzxatalzqmmusz", "vyblntmskqtjfcjqphygdnoruu", "moeumyficjbpgifnfjhtabbuqb", "kehgkczgxkzszjdxpamfqntvsd", "pymdwwwbheukqsijqeaaayqqvr", "rnbqbalhzrrhonzakcryofdkbj", "xuqlhpbigtxdxleuoygfngdgnw", "xlmwewgqmgbamgotbjfbinhzev", "kicddmdturcrudelhjzqiozdmq", "fexgjgvheqshxrxjefooilfgfo", "zquxjxnswxhbglxazkjzrnmdur", "dvdewccyqofbsmlpvpvcmczraw", "zdgcpwdjtcqulopimuotaxwtoq", "lmuazbwuyjtuuqxszzixfkqnoi", "zkhacgtxeppzukvprcqizvswma", "zqxibfsfzfjulqaebopialcysy", "nirvhuamaysjhnushrdhlwrfbp", "ovclenhijnerhkffxumvgzqwly", "gunzijgkwnsrxqworhrlbxlzys", "yaailedbpvrodgituebgmrnnzc", "rqxopxkgwfreuixbzlidrfvusg", "wnpqvfggvwnqosktwhlnhwbyit", "uvsicgovhekohrxomffnddqnbg", "mlwdygjtqbvdwisrrzdihqvtbb", "bhtriloesknpjmpcwxyyxgujzk", "meaqzlmiiczladkhgyiqzvpbko", "aovddxyruzmhyxjonqindxqtnh", "tilkrmbxsdwaierjtwctkcodls"]	[974]	TODO
"iftjrpgqmsdtyvlicwhvxdufebzlxicjtkfajfpkkcauikeswpbzlnegednsjzmxdblglhwcgjjzburyzfwujhbadeggiluappthtjcrxriqxmbhyausavgcmqlzvjqqyewzylvgwymfjrzsfwjnlrzieupmsklhpvdssyxzlukexiiwngvfryetnbhyycyxskeruivtkcadfwdjqyihimtoralfrthlbpwllvwmstfrpebrxkrpcuiwvoxgnxlhnnvfolyekqjawduoisiswazllrlxixsytuqnrjcppeurncdoubhosdponggyoznngsfkqajkydtefqxgtzbcpfbcfjagcwdvdklfuesvlcqanytqwxlrkehzuafttpgmalyimwoimbgxveonitlvylavrmgbwgpaishzzotulpwxjujwienhgwnklnblszrjrrcnxrpyarcxfexrptpptcpwzzmtegxahyksotglacbvwmgthebthftshelpkjorionpnnqwdtlshvmemrbcisxviaqnsumaqsozybxhsbiskfngihlbsyrbihkjycxbfwcqauqmnsfmkpvijzkmqrpzttmdruqiyvxitffwkhlrtzloeqakhozjdocvmvotxgclfunzuzisexkpfbjxmlvxtsbeavalvrzpxblgmxswedpzhukqjluobisiuqxehrbzupzairjvlfyccynetpssqtjjemueqlnygjniuhfjompyjgufkkkgjbjbrnyezrozurtcpvesxbgmtuabuabdixqlabmcxbuqfdvdyqagjalodkvhurnknscgwilokjuxcprjrfpynglbhsuuieuynjyvwtphuszjvvfcpipcihpiddhynfnflepmauqvwohnrzxatvrqvyzywdnveopgsbmglidnedutpwzunvafeqmrfzmdkksdouztkjqecbykagxhicflvyqaqlchmodjmtfqoykbvuykugkhcsligvqcfmgabxzrnhetorxtfgjgcyglglugfacgevaujmshqntymvzyiljzrpbrqnkykcarsdsqutwyqjnnwjesebttfxbojbcajtoqlhlpavxjwjwwfkdxymlqbkadorcvaadkyfastcqjecasqqpbngpkkxifdsawcqepyomdblqfsjkzetmcpkwtzsnjpwpkqbajnpqegczxezepmqkwghrzsmllchqvaphkbqrbvilqagekmrhmrtovetsqpfdondzesiuuupjdpbvwomcdwaykxghiuippynjqosammsxgwjwfhlkkrfpdyrymcxgtapelmudskrxwufofbzxfwvpugfalktgyuerazvczqyxachmjsbndrqhhoacfxcqwqwjolkwifzhusmsptycajcyvttpnhkvqegumkuzsgxgsbsvfhivaxehvypoyjtburitjrnmkamisffko"	["kqbajnpqegczxezepmqkwghrzsml", "xtsbeavalvrzpxblgmxswedpzhuk", "ccynetpssqtjjemueqlnygjniuhf", "thebthftshelpkjorionpnnqwdtl", "rfzmdkksdouztkjqecbykagxhicf", "nwjesebttfxbojbcajtoqlhlpavx", "hcsligvqcfmgabxzrnhetorxtfgj", "vwtphuszjvvfcpipcihpiddhynfn", "gcyglglugfacgevaujmshqntymvz", "vmvotxgclfunzuzisexkpfbjxmlv", "flepmauqvwohnrzxatvrqvyzywdn", "vetsqpfdondzesiuuupjdpbvwomc", "pyomdblqfsjkzetmcpkwtzsnjpwp", "yiljzrpbrqnkykcarsdsqutwyqjn", "qfdvdyqagjalodkvhurnknscgwil", "cpvesxbgmtuabuabdixqlabmcxbu", "qjluobisiuqxehrbzupzairjvlfy", "jompyjgufkkkgjbjbrnyezrozurt", "hsbiskfngihlbsyrbihkjycxbfwc", "veopgsbmglidnedutpwzunvafeqm", "okjuxcprjrfpynglbhsuuieuynjy", "qauqmnsfmkpvijzkmqrpzttmdruq", "jwjwwfkdxymlqbkadorcvaadkyfa", "lchqvaphkbqrbvilqagekmrhmrto", "shvmemrbcisxviaqnsumaqsozybx", "stcqjecasqqpbngpkkxifdsawcqe", "iyvxitffwkhlrtzloeqakhozjdoc", "lvyqaqlchmodjmtfqoykbvuykugk"]	[495]	TODO
"tzzsxfpkndgydmuuaiwpflruplzjxqyyggsuzligkhgcbclgxudrmljnlbibxxxuuzklqlgmtkwvoupzsasxoaeopwqmgsknujnwciholduhbyfvfkroxlemahezgypnjgvbmszmjlrkybkfvysxvccwutyctpzfscirweqnekmelpxfpqrggdcczzpueeozhnkddhhvjbdjtljfqtjbjrkbkwccilgyvwdedpdutyypvjznwxdnacxeystitwrkmycgpsqwhqqmgiacoighemckimlvkbkbbostbmdqwmujymxwymdkrmzurcuyerxfcqeewqhaudywjxupcgwtvnrxppkmsvtaccgqgyfckfyobunkzyzjcshbwjnkpmbrfmejoxibiiqojpixpksbpgmzkamfdcgrfatmpynsrzetrwymronmqowhksscafdmujxqjeuhmpgzqbwezvpgmqliukxtdnibiadtggpqktpsnjjjzxevsegrqaqhleyigdfsfcmxancwpicrwsxkqoygsqlskvlfkasxyilfxqohefzittworfyqnvumymhstgzmsqtczxfhrnnnmyujvabywzulleksomrxantneeultlvblwsfoqvtpwdprclcwihoriwlwhvdtywtwtkthtpvxojafpnakukyqrnycyduqxbvqfsotfmymylhinkwazvvtynuqktznyczywvtauhdutgqsaydyvkhntdcjqigcddjbeuzpxuqcnpalgxyivhrtjtubfckxsowjtndcasplwcwjkfsssqjfhnbhgfzvoyzinuxlrowivasdupcerrenkamamwuxvnwyabngjvtzughstfjvbhnfeauzuhmausatvllzltiufqxenserbtraepnifochbnixnitvlywfzbbjnfhrkcjcrpdbqondwxlfusvusahwzqnjqutsluaiqbozqwmyimfziwyyohwfovqauokmtbqmuallmmlqxwiauiwknudwumusxirnokakxokcedgvxhujvmaydbvbnonknxhwveerinswsvanhhimrzavturmdxpswyefknbwqnuunhambceabgulnzmktnpdnoetuaklfruyqtudupizkqzhifpvlekngyscfpcwhfwokspbfkddmhzqsensvhhihiksshdghbyjyikvlcemfsudcfzzkakgjqlwwdjtwpulsxfhkxbxzpnbjjtwqccricppsxatohdeqdcolkpzwgdzkqyoijcmxxynlammkppoaxeanuylqdzsmzxqbkwuvwllhsmglyyoxkhebhexpscywtqijlzjwzjdfffaffhrkilfndrbjtrqpkretsoxalnmfldufppx"	["antneeultlvblwsfoqvtpw", "dprclcwihoriwlwhvdtywt", "zavturmdxpswyefknbwqnu", "knxhwveerinswsvanhhimr", "casplwcwjkfsssqjfhnbhg", "vqauokmtbqmuallmmlqxwi", "sshdghbyjyikvlcemfsudc", "spbfkddmhzqsensvhhihik", "traepnifochbnixnitvlyw", "xyivhrtjtubfckxsowjtnd", "unhambceabgulnzmktnpdn", "vtauhdutgqsaydyvkhntdc", "xlfusvusahwzqnjqutslua", "oetuaklfruyqtudupizkqz", "fzbbjnfhrkcjcrpdbqondw", "wtkthtpvxojafpnakukyqr", "inkwazvvtynuqktznyczyw", "vtzughstfjvbhnfeauzuhm", "nycyduqxbvqfsotfmymylh", "hifpvlekngyscfpcwhfwok", "okcedgvxhujvmaydbvbnon", "jqigcddjbeuzpxuqcnpalg", "iqbozqwmyimfziwyyohwfo", "auiwknudwumusxirnokakx", "nnmyujvabywzulleksomrx", "fzvoyzinuxlrowivasdupc", "ausatvllzltiufqxenserb", "errenkamamwuxvnwyabngj"]	[590]	TODO
"jsspcrqdxmkpbyezjpzcjazaltvtodnrfxutqqnglnwrqmppqeqmubdxqmuihejeyjicpafekzllxenfowhoqglgaqavdbybgjawnmcnnzdhdmeahmgswdvqskafgemsztwhodplujctuelhathpvpnviusdemdtrlndjdjsakwwvovkwiquzfvnfxmcethqspjjjorgrnmlvgqsfvssuzvffetumezmwlkgchsolmcaaxaqdgmdrnxnjkbknoccccfmobumwctpelecyghwkicrpwofgsfbkpfjtwkehtwiuuqrgsngcazlpirwcgmmfhkvnkhidvlhxnaoncxbffhhhaeykajwzochryoaqmlbaoekoyabxzziodkrqobadazgeqkfxzioqbjizefdhoyfftgowkgzftykkrbzmtivqcnanullsmyfolnnljtrdgrfzesnmuhvipkwlqollwrmjxfizlukyrwuqabvwlthgwnyjluisjlrqrubikgoopsutnnztmmlygkdykrtjiapuadmbquxvseunrvqkbercnnrgxavbmgbwifmvfgtfoychqlddtgtikaavmjopvxybksobewpxvqmaehzpzslzaytwhboijtwodanipwefrgmzzvewvwkjgwfzqbeppmurwgsrmeeksgqzofsqzjirfymolnugfczpfzcdtnwwsjsygocrrptnkhzqlxhrnucuvmhigvteztlrazfvgzobmmtegnpjbzjsxwuocyxxgammjhbnmxsqgwfsihrtkydvgdqbbfociuimrtgjuemgcwglnzkgiwrfvmiodcjocmksynjhjuzsttqicpwiybyiajczuspimicowjdbjjgfdhyyjekhotsgdkrwkchclrkotfedaslzdmcwnkvvdvjeetmvyygufnjvmzuwzxksekwjskldeqiyspqtudtfpduquujzerqyortoosbxptmmozyouabqpfepfvgklhymbgsngbywloympaklianvmjfhqchbhbwxcarbmfpxgsgtbnstuecmztratambitjpxttexsyysqantaqtslolkwohlslxwiajjxvzlmiivdwipyypmteceqyfimkyzfdqomgppazfqsdnybaoqusaqtqvrpimrozdsyyixitfinkjsftpftthgkpzqzeuihwibglrdknhegwvcebtmzbbldonulnisiznfbzqgtsrlwlzkhciubtxlbhqhledxdckieldplaeryhobycfztjgqthsjiwzhhloinfzhmdaoegxpgkgpruvfhvgokrftmbjfcpxirjczvngrvucluerryxhrivgqovokaipnupdvfiquqllqdumnxrxblohilfmyyzqybsppcnixdvfendjrbpzhumoldkugxlxrpgklkpadamckrjrxcpmclsxkkenzwtphlmcllfjohsybrdrsrkucsxmjtgqvlvmanqyto"	["ssuzvffetumezmwlkgchsolm", "fizlukyrwuqabvwlthgwnyjl", "mcethqspjjjorgrnmlvgqsfv", "ndjdjsakwwvovkwiquzfvnfx", "ngcazlpirwcgmmfhkvnkhidv", "ofgsfbkpfjtwkehtwiuuqrgs", "ivqcnanullsmyfolnnljtrdg", "lhxnaoncxbffhhhaeykajwzo", "avdbybgjawnmcnnzdhdmeahm", "krqobadazgeqkfxzioqbjize", "fmobumwctpelecyghwkicrpw", "icpafekzllxenfowhoqglgaq", "rfzesnmuhvipkwlqollwrmjx", "wrqmppqeqmubdxqmuihejeyj", "mlygkdykrtjiapuadmbquxvs", "chryoaqmlbaoekoyabxzziod", "jopvxybksobewpxvqmaehzpz", "ctuelhathpvpnviusdemdtrl", "fdhoyfftgowkgzftykkrbzmt", "zcjazaltvtodnrfxutqqngln", "gswdvqskafgemsztwhodpluj", "eunrvqkbercnnrgxavbmgbwi", "fmvfgtfoychqlddtgtikaavm", "uisjlrqrubikgoopsutnnztm", "caaxaqdgmdrnxnjkbknocccc"]	[18]	TODO
"xtrregvumkcowqcyemsmfrqbowharjoahmvseadabzsiulxyzlnpjdiqoornomblirjzjursczazgtboehamsptkjwpbrigvvvqlmojruifemecaypkyoanbhjnwindpzwhwvmlfzblwththzadmcatolvvdzmzuscrgqjfusqrcipkvelkbcjfhlobrcntiscczpstwowuyfwaxezyobmlgcvsfkprnmadgjbioabzoxrgnfshuunubkdetztvthhphpuihdvimslwmaovfpkeavyuqpmxbamtdlnbmkjxnlhwiidrnvtoldisozlfskgpsklhpcfyhlczpnkgqjosesrczarobrjouclrmbsyjiqpsetkmvnvvuwrflmdafifspuhiedikinkzydwjvplnoywsmkyigfataumfyrpcevyuetufzzihoetpiduxykuxxlbcyieuwmjbsndotkxllfepvvmlzvwyixwchqqqdqftevvbowysgupjmrltjehiooulmtggxfwozhmuofhkxzzofrxfpfrateigbigvspqnzdlhynxltssvbloiqkwxluxjqaakdgtipfztisefshookdghlikpqbtkjupdhqnzttampniilsjqdjcfwygabtzbrlwwsyjcdxbbqaasaaqmaaldvvmgetzpelkexkofsfdzoekrkhdbfuwnkbflxdezfliqsytrfbnttwijqfghxivbvovwluaoowekwsmgqxtxunctwxqhdstundrbyyukpahkvykgijxqndiskvhlgqomxmhlfvrjlwkcptxfhptabnvmkeknchceyofkzekgbdxxbhzwbihobmcuvsitphrdlulgyrrsclvxnrhhlgxyedmfdzyqcscddhpewwtndeqjpiumlzfkxlwngcexlznfxyvmpexqggqtitsdlevtfpyfnhzbcduuhmlzvwuvwtdeqwrsbycedwvabbjlwuoovbuxxachunswjbwbsfdtshhqphyfgotaurcqgmiuwibwjaxyzmpoaqedwmapchdbpofpwbgmjzsasvxnoehqpscohpjzqdkxacmhleyiwrdcjnyoadmutqwslwnyztisoztbpdlkwfgtisvttkgohifnmpfwkritnnwjjektvkopmbksenogswnekpztxjqrnvrzfnanwbggoobiduiwsbzmlfypfqxpslvuzliajxjzggjpuifdahvcjjnkrryrvatrpnydryiqsiaheosflgbivurstgzujxtpbpbkpjewcnoodnwunxqkzzkikeozkvxmdywqybviergrmwecmcgwyfeolxeqcndofoemffrvurjvlepkqpvryunaqayaqhqtipjbyrguognsejktdowtwsmvjulrgycctpvtcygjjnsmknsvdxuoavbxnvjmaprenssgybgvhgfxmucykzzbrnyekaardyplgivsajgfgnqmlafrsdozvzwqbtncpjhwiectmwymsbljsqgrinkcegjwwzfnzjyvfweimhqhpyuizmlgcqxoowajakobqzghjhnkgdxwtqmipolmmdtwkhtbxlogrkhgaafjmrtjngijnpmxosuhdrcfvyuyoygqlfrkhcklcrlgwqayzouxnzzoqpketkpmwwcquyjzgikiybcbfzvcfrjtczgohpcqfmnxmnsmgnzymyqibbhdzubjwbooxgezfxgibszznmocffhdesrceoczfjuzjyffcuqvefralndbwriqbajwrpvupmwpnggruqyyesxffmdsdokirkfqynwtcnkgmkrvmsljqwkdsxwprjfqzxmqrslimqlamjcastaqnbxuyussufkcbwjoiiszyjsfaikambrckarnfzmxdwecfmgrzskqsmdaqvxdyaknxucbprvzcuyblykrrdnbjasrclwiigbthlcbawmpruiymgbdpmcpoligteimeajypcqdnhqegyeuytywyifohroqdgdradbdzortlnslkhonbosrsfndhtxgtfqhvorreqwfhiqxnubuwqdctjkshsbrekpntcesjreulwobrutltbtzsaotjfimcfxoszfgfxuquiftqgmxbyyzazxaphnnvsdjnagwpmvbzncnkqqebbwsmhvgyonaklawwlnfkzddtoaamrktzgttedwhxjubifxeqqvhuugyijvzsoxozuaijhnxuiaorcxkvianojfylzoauyqcerheplzsdbnwvqjxaxbrwerdinebfcvxifnfotelxaepseevotsyrbtlesglxawhkjjttemnfagmnektrmpqeqyjzglyaudzudxgyzmnbmcmlssyuwbylqysqlrrnwfizrlofqpepmjuhymvwtjdcjtjicysfnadewlvvuneaoyfqmnvyzuizycjwwsrsvcdphueyiglgsqouubucdovtjvntjmwlbkupxywesedswxervvahrlsrcucpafhycjtejkgyidgmnhdkeeipkawykfwbxqrebcjsyvrxubzxpisqqxiupeujlrswkqbmjbhygwiexjoecktjrmucaacivcmqjhpjpbvwacbttusfcckxrchjhzweybcypmvktxjuhbgqdrhoaxsvdpvbltwlcuxflppeedaswjzzrchvdpaboiormavbfwezfrwactvuescplzhnauurziqtwbcylqoonvrgughybztjfbnzplfltdfowbkenhwpulwjvqvgmdylikrnbubcydgwpozgljcocuqtpbpgptlujvisnvlnuxsbrobybaovkedvdqyolxwcwulgntmluuvhirejgclozmzidbsmycrwzvwhdbkypoeumynfizwjtjiqsxdyhcpctfoqdtbolpwktycmbukxnrjfldmnorgahngbvbfxlygmgxlbqqjeoavsunuieetgxwbplumpeesezapurdvneamvqvttfowqaxawknkiinogoaunmmwaosxugfgnwidhhmqlcedhaxtbcgurmqywzirqqqdlvrfedtknsxxjpfskmduawmhjzwqflxzcjdzebeizntbygoomaiztrxekmcwkuaguezawwwajnsvnfzwqjjirckmqjsmuymahtxqohyolrbqmmlpflfuhwlpwjgryegesltknpdqcwnqrzxugqatlckepfpplprahwqxfcggumohwyjwzlnrhpdzyolljjwmwvoywnssckpfnhrhmetvrzqguglmjdxterdbmtqrvihznticsnwrdlqyvsflwzfbkykituleonipyenslszfvfmxexdbsykkjdrtsasnoljofzkqnetzvjjfcediuvruhbyhsrlfyitkgjukeyefymxijfeuotlcxaklgrojvazjxczziipcqfurcjdghuckksqkzmzsneysbonjyjtbkrosgxgtzxjdxqlytsrvtbjcuotuzodemaefcdgvnvurbkrcmodyndciifogwieswgenpukvmwshgzoemxhxnktbpxbftpfocldknxqchkotueblopwpaocdgvathzaormhfoislgfehvtmzqsxrodpoueayickxqxbutootpibhnhwdhhpisksdlvthwafxcezkxhvmogjthtbrrxlzsvlaafuekxnjntksrqhfqujcrsxovphjhklupnvyskvfabeyfgndhoodfrazcnzktrwkfpomarlxknipnsolfdfwtojfdbwbonmtgpsjxawbqmxeegnlhidqyehhpqcadqhtidhtmowtwhbbhugrbtorbxdignwtuoqoxilzjdxtsvxtkawmuadhcqncugkaohryzvozegatypqodxcjczhmulqalmcrvxbqcffofzlnvjtexfeepyjgaracetxmfvpbogfwzbsbbctvgsfcrfcjutpjqemtfgwwgrmokeumqrfozcvkbwzhnauenvgcviujvxobowtelvwgwpkikdndeirlcqtwygtlavgqpttudnhqjaykukvvrjxxqfurnyvojyfhdgjsnmknoowwhhtthffwwxlslxfcicknxkfqwcejjrwuwnrocuyukiestvlkdrtmfghsxyscbxzabkrlxroslxqewyikbmphebdoqwgnhzqpekuofwnohecbeemtjrrfzcwmupcvlahnzvpdpjarftkvsweyxtmyfgfipschjzlbqmclmpylzocoyzoiapwzcrgnqcxqjwfqbbyecjkvogqqzevsqpolikbvsysyweqxdzooqdzmdudivearrqvvurxugveinchjaxqgnumjlyixutatilhbafpjzqwtlqtwjiinobnbqsawcxkmdxtmbknmussozpvqupdpxligjwptmvsgwpexvazmvotqldnozvascpsckwfipmifrkqybfngtybmhhwxmhlqzlludoqztjdwzcwfssutgdstrcneobwugdahxsxfsnsnycwrisilwieihxoijvbjushkqktzpcdtmziznurgodiifshkjckuiiijrnzcgifeysifdlfxushxrgssckderkeowwyiumkmhgisvblkofsnusuqmgcdkqayllcoogcigelatcblsqzhkwiiwufgtqsesxikxhsxyacpdlhpgwbfmabbfdbjcbexyksiiqtxgofhbjbztntsocqtnotyusimkazryxasgkdrqiflsjlkcyaykugxhioawujcqacqqnnnrpzbpgukgfoklornsnoxcqharkrotupwsxliangawnqepoaidrennsqunkivcntlredgxhvhlsgefazvyiqfxmarwdgfawqgbwgvovebgetffiknehikvdftrfgggzgzjrqqgtkrsvmmcixooehzrlaoolnzrmegetodqttzespqxmfrjakriqnjypzbgwbhofbmjxpflotwcgitvswpzgpopluwhdoiyuqvqansrjwxjeultseasrqijteubxqrqmgmonumnrbztdrqwdycwbetwjraioyvwykvfcopluvesspwpwukivjeagmtnfdymlvxtzeepfjwmtmgoxfywfhtfjqckcwctpezljwufpblzhaufzustgpjjipohnjbjenceszlimpjjdmkxvnfvvfxcjrkngendxrgaoltchdprjjalnzxkdpsdckjxlznpknetzboiwjlwjidzgkedyebplsepoiodbxbfauqtnsknxlhxqgmrdtcfwosyynhbqtdrrcpmlvitxouvovyauizqykbyttqlocaneeifuegkxuqsmzvvgbsgmbysczagycnuobaiwaymfzuiumtuhpuvieghwlhptabasytwlpsqadjkjhxebouvcmmmkjgaxqxlzmeygtzazbzrcgpxoswgubmcsutltfwaizvxiscjojryjciqceqzwtjwghdwjzhcfudqdoqxoklqsdmlrtycqvfoeyyebdodyxchsjnkkbekcaraubdwryvpvjsrukpmrmjbmoepujvbisjozdakdlahcytbnktmittbvgikjcmixmjyyxnhtqgfzwdegrjiieatdpadnnoqwobpgmbwpzsxjtnjwowfxtjnzaldqbclfahuocqjvzcvirlekevbglmkikvamdilezocvmpldfcfuelxgwjrdnnowzrslvjkrqsgdclqsthdsffrgkqpwdancgutafvghjgbclnifvneowdogivwkissxewcvdcedwtzdygylnessrnblzxbglqafldouzcgjnzdkkdrpgqwqdijltblukpxboyphipusvgkbduipwexzkxglvaozdrmxsroiwixdibifhesoyamocmbpouvxekthulnrdbwnomilvlgaweqfaosbwjybkpwwusigqemuvbnxgmcwaasiqrjasysndxysxisjkuuqtcgtqckytmxiecwtiwakuvkzcmqjxwruusrdlfhmlfqnslvxeirjwfzfifftymrmhzgnptimjvcyxtxkfjzrfmuqxiclzakcsorpllgcxxihftxxhyaauoyzsignwngwdqffjfbcblzdeskjgzamhvwdppjojjydbnybisvjjsdmqlmbsktdqosljysjjrebmmozhbbuoivftndptbqlfkpnkioklimkzpeclwzgfqujdypzqxytgwvkfqdovjeqpgaucbhbfgbayisbhrwtcpabxefimvvrjldpjblorgqslzzmnjjgdazfkdriegxmlmrchygtyqwxuaqiarlmvglohjysjluizhhwetohivkzlhjwdcrhxvlflxmiplhlmgejdiufcxdeohzakkusbofgricctkeskggvlhzeoigdozehuytpzjpfimgmwdeypeamysjklglszftcnqmhqyvyuynbhxrzngwkgthltmjlcthgiadyvuvmmzhyswqfpxccuztsphansumafgxouwtvjqjsabedyqoemlhgmumhlxnqiquovrqlnqjqkmcopgwgloropeihkbirkqmqodstiyiguekgeggnobdjtfujubgxfuypsgzxgjiueruvrezmtlfoqazwszmfcfscuoeuoklwfodhxljfpkpablezrjpikwuxvyqzzyadkmgrkjuvkbcejowsqkxhgkkvohsueygxmrawrftfhkluthdiamnlwwxjbvuwlhhztfjwihroajiuuoofpdqnoynfalgikdjjvlpcmcjzcppzjlhpuigwcmrtqbnhwkupqbkdxzievmpvzzdcjdmwveobwpcnyzvbkocshutulknrealuuzrmimtfgkwjepbialamzmlrwbzqggthzwvjsekbiyskwbydgljkzinvjhsgtphxfexejrtiswyxagnalorssejjssgpiemqjqpvozcfairciethiwdxzdxowiamknpkeooiuvqnpnrniwvemh"	["zmpoaqedwmapchdbpofpwbgmjzsas", "ulmtggxfwozhmuofhkxzzofrxfpfr", "gyidgmnhdkeeipkawykfwbxqrebcj", "esspwpwukivjeagmtnfdymlvxtzee", "ixutatilhbafpjzqwtlqtwjiinobn", "xwcwulgntmluuvhirejgclozmzidb", "wxmhlqzlludoqztjdwzcwfssutgds", "abkrlxroslxqewyikbmphebdoqwgn", "izntbygoomaiztrxekmcwkuagueza", "plprahwqxfcggumohwyjwzlnrhpdz", "xqkzzkikeozkvxmdywqybviergrmw", "tshhqphyfgotaurcqgmiuwibwjaxy", "qodxcjczhmulqalmcrvxbqcffofzl", "seasrqijteubxqrqmgmonumnrbztd", "rmhfoislgfehvtmzqsxrodpoueayi", "itkgjukeyefymxijfeuotlcxaklgr", "tcesjreulwobrutltbtzsaotjfimc", "rqwdycwbetwjraioyvwykvfcopluv", "gxhvhlsgefazvyiqfxmarwdgfawqg", "bylqysqlrrnwfizrlofqpepmjuhym", "vlflxmiplhlmgejdiufcxdeohzakk", "iegxmlmrchygtyqwxuaqiarlmvglo", "lwzgfqujdypzqxytgwvkfqdovjeqp", "vlepkqpvryunaqayaqhqtipjbyrgu", "xqlytsrvtbjcuotuzodemaefcdgvn", "zqguglmjdxterdbmtqrvihznticsn", "foklornsnoxcqharkrotupwsxlian", "amdilezocvmpldfcfuelxgwjrdnno", "iqtwbcylqoonvrgughybztjfbnzpl", "knxqchkotueblopwpaocdgvathzao", "bwgvovebgetffiknehikvdftrfggg", "jqdjcfwygabtzbrlwwsyjcdxbbqaa", "wrdlqyvsflwzfbkykituleonipyen", "gruqyyesxffmdsdokirkfqynwtcnk", "nvjtexfeepyjgaracetxmfvpbogfw", "qjeoavsunuieetgxwbplumpeeseza", "usbofgricctkeskggvlhzeoigdoze", "jektvkopmbksenogswnekpztxjqrn", "gmkrvmsljqwkdsxwprjfqzxmqrsli", "ndxrgaoltchdprjjalnzxkdpsdckj", "gaucbhbfgbayisbhrwtcpabxefimv", "tcfwosyynhbqtdrrcpmlvitxouvov", "edswxervvahrlsrcucpafhycjtejk", "ekgbdxxbhzwbihobmcuvsitphrdlu", "exyksiiqtxgofhbjbztntsocqtnot", "kzmzsneysbonjyjtbkrosgxgtzxjd", "ojvazjxczziipcqfurcjdghuckksq", "saaqmaaldvvmgetzpelkexkofsfdz", "sqouubucdovtjvntjmwlbkupxywes", "mgqxtxunctwxqhdstundrbyyukpah", "esoyamocmbpouvxekthulnrdbwnom", "rocuyukiestvlkdrtmfghsxyscbxz", "lsepoiodbxbfauqtnsknxlhxqgmrd", "lwkcptxfhptabnvmkeknchceyofkz", "bqsawcxkmdxtmbknmussozpvqupdp", "hqegyeuytywyifohroqdgdradbdzo", "purdvneamvqvttfowqaxawknkiino", "grzskqsmdaqvxdyaknxucbprvzcuy", "aafuekxnjntksrqhfqujcrsxovphj", "fxoszfgfxuquiftqgmxbyyzazxaph", "ogcigelatcblsqzhkwiiwufgtqses", "qpolikbvsysyweqxdzooqdzmdudiv", "axtbcgurmqywzirqqqdlvrfedtkns", "mqlamjcastaqnbxuyussufkcbwjoi", "osuhdrcfvyuyoygqlfrkhcklcrlgw", "nnvsdjnagwpmvbzncnkqqebbwsmhv", "edwhxjubifxeqqvhuugyijvzsoxoz", "vpvjsrukpmrmjbmoepujvbisjozda", "vascpsckwfipmifrkqybfngtybmhh", "hyaauoyzsignwngwdqffjfbcblzde", "fltdfowbkenhwpulwjvqvgmdylikr", "nvvuwrflmdafifspuhiedikinkzyd", "kugxhioawujcqacqqnnnrpzbpgukg", "nzktrwkfpomarlxknipnsolfdfwto", "bszznmocffhdesrceoczfjuzjyffc", "zgpopluwhdoiyuqvqansrjwxjeult", "dcjnyoadmutqwslwnyztisoztbpdl", "txqohyolrbqmmlpflfuhwlpwjgrye", "blykrrdnbjasrclwiigbthlcbawmp", "aizvxiscjojryjciqceqzwtjwghdw", "skjgzamhvwdppjojjydbnybisvjjs", "mgnzymyqibbhdzubjwbooxgezfxgi", "kuuqtcgtqckytmxiecwtiwakuvkzc", "kiybcbfzvcfrjtczgohpcqfmnxmns", "pcvlahnzvpdpjarftkvsweyxtmyfg", "lgyrrsclvxnrhhlgxyedmfdzyqcsc", "wexzkxglvaozdrmxsroiwixdibifh", "yauizqykbyttqlocaneeifuegkxuq", "yyebdodyxchsjnkkbekcaraubdwry", "btorbxdignwtuoqoxilzjdxtsvxtk", "krryrvatrpnydryiqsiaheosflgbi", "ilvlgaweqfaosbwjybkpwwusigqem", "blzxbglqafldouzcgjnzdkkdrpgqw", "uvbnxgmcwaasiqrjasysndxysxisj", "bfcvxifnfotelxaepseevotsyrbtl", "trcneobwugdahxsxfsnsnycwrisil", "mhgisvblkofsnusuqmgcdkqayllco", "nceszlimpjjdmkxvnfvvfxcjrknge", "hpjpbvwacbttusfcckxrchjhzweyb", "awmuadhcqncugkaohryzvozegatyp", "ifdlfxushxrgssckderkeowwyiumk", "wwwajnsvnfzwqjjirckmqjsmuymah", "pfjwmtmgoxfywfhtfjqckcwctpezl", "rmokeumqrfozcvkbwzhnauenvgcvi", "urgodiifshkjckuiiijrnzcgifeys", "vabbjlwuoovbuxxachunswjbwbsfd", "wmjbsndotkxllfepvvmlzvwyixwch", "hjysjluizhhwetohivkzlhjwdcrhx", "qqqdqftevvbowysgupjmrltjehioo", "zfnzjyvfweimhqhpyuizmlgcqxoow", "gawnqepoaidrennsqunkivcntlred", "kdlahcytbnktmittbvgikjcmixmjy", "ffwwxlslxfcicknxkfqwcejjrwuwn", "ajakobqzghjhnkgdxwtqmipolmmdt", "dghlikpqbtkjupdhqnzttampniils", "vurbkrcmodyndciifogwieswgenpu", "qyehhpqcadqhtidhtmowtwhbbhugr", "jvisnvlnuxsbrobybaovkedvdqyol", "smzvvgbsgmbysczagycnuobaiwaym", "vrzfnanwbggoobiduiwsbzmlfypfq", "uoivftndptbqlfkpnkioklimkzpec", "zcrgnqcxqjwfqbbyecjkvogqqzevs", "qfurnyvojyfhdgjsnmknoowwhhtth", "xligjwptmvsgwpexvazmvotqldnoz", "pjhwiectmwymsbljsqgrinkcegjww", "thwafxcezkxhvmogjthtbrrxlzsvl", "zfifftymrmhzgnptimjvcyxtxkfjz", "ecmcgwyfeolxeqcndofoemffrvurj", "uqvefralndbwriqbajwrpvupmwpng", "qdijltblukpxboyphipusvgkbduip", "lcuxflppeedaswjzzrchvdpaboior", "ognsejktdowtwsmvjulrgycctpvtc", "vurstgzujxtpbpbkpjewcnoodnwun", "wygtlavgqpttudnhqjaykukvvrjxx", "goaunmmwaosxugfgnwidhhmqlcedh", "wjvplnoywsmkyigfataumfyrpcevy", "rtlnslkhonbosrsfndhtxgtfqhvor", "zgzjrqqgtkrsvmmcixooehzrlaool", "fipschjzlbqmclmpylzocoyzoiapw", "jfdbwbonmtgpsjxawbqmxeegnlhid", "mqjxwruusrdlfhmlfqnslvxeirjwf", "psqadjkjhxebouvcmmmkjgaxqxlzm", "gesltknpdqcwnqrzxugqatlckepfp", "oekrkhdbfuwnkbflxdezfliqsytrf", "vwtjdcjtjicysfnadewlvvuneaoyf", "vxnoehqpscohpjzqdkxacmhleyiwr", "ckxqxbutootpibhnhwdhhpisksdlv", "gyonaklawwlnfkzddtoaamrktzgtt", "obpgmbwpzsxjtnjwowfxtjnzaldqb", "nzrmegetodqttzespqxmfrjakriqn", "eygtzazbzrcgpxoswgubmcsutltfw", "lgivsajgfgnqmlafrsdozvzwqbtnc", "wieihxoijvbjushkqktzpcdtmzizn", "esglxawhkjjttemnfagmnektrmpqe", "ujvxobowtelvwgwpkikdndeirlcqt", "vwkissxewcvdcedwtzdygylnessrn", "cypmvktxjuhbgqdrhoaxsvdpvbltw", "earrqvvurxugveinchjaxqgnumjly", "sgybgvhgfxmucykzzbrnyekaardyp", "uaijhnxuiaorcxkvianojfylzoauy", "lznfxyvmpexqggqtitsdlevtfpyfn", "reqwfhiqxnubuwqdctjkshsbrekpn", "nrjfldmnorgahngbvbfxlygmgxlbq", "qmnvyzuizycjwwsrsvcdphueyiglg", "yolljjwmwvoywnssckpfnhrhmetvr", "vrjldpjblorgqslzzmnjjgdazfkdr", "xpslvuzliajxjzggjpuifdahvcjjn", "uetufzzihoetpiduxykuxxlbcyieu", "jbhygwiexjoecktjrmucaacivcmqj", "ddhpewwtndeqjpiumlzfkxlwngcex", "syvrxubzxpisqqxiupeujlrswkqbm", "qcerheplzsdbnwvqjxaxbrwerdine", "kwfgtisvttkgohifnmpfwkritnnwj", "xxjpfskmduawmhjzwqflxzcjdzebe", "hzqpekuofwnohecbeemtjrrfzcwmu", "jypzbgwbhofbmjxpflotwcgitvswp", "xikxhsxyacpdlhpgwbfmabbfdbjcb", "yusimkazryxasgkdrqiflsjlkcyay", "dancgutafvghjgbclnifvneowdogi", "wkhtbxlogrkhgaafjmrtjngijnpmx", "ateigbigvspqnzdlhynxltssvbloi", "yxnhtqgfzwdegrjiieatdpadnnoqw", "ruiymgbdpmcpoligteimeajypcqdn", "ygjjnsmknsvdxuoavbxnvjmaprens", "jwufpblzhaufzustgpjjipohnjbje", "xlznpknetzboiwjlwjidzgkedyebp", "rfmuqxiclzakcsorpllgcxxihftxx", "smycrwzvwhdbkypoeumynfizwjtji", "fzuiumtuhpuvieghwlhptabasytwl", "qsxdyhcpctfoqdtbolpwktycmbukx", "kvmwshgzoemxhxnktbpxbftpfocld", "iszyjsfaikambrckarnfzmxdwecfm", "zbsbbctvgsfcrfcjutpjqemtfgwwg", "bnttwijqfghxivbvovwluaoowekws", "qkwxluxjqaakdgtipfztisefshook", "hzbcduuhmlzvwuvwtdeqwrsbycedw", "qayzouxnzzoqpketkpmwwcquyjzgi", "kvykgijxqndiskvhlgqomxmhlfvrj", "jzhcfudqdoqxoklqsdmlrtycqvfoe", "hklupnvyskvfabeyfgndhoodfrazc", "nbubcydgwpozgljcocuqtpbpgptlu", "qyjzglyaudzudxgyzmnbmcmlssyuw", "mavbfwezfrwactvuescplzhnauurz", "dmqlmbsktdqosljysjjrebmmozhbb", "fzkqnetzvjjfcediuvruhbyhsrlfy", "slszfvfmxexdbsykkjdrtsasnoljo", "clfahuocqjvzcvirlekevbglmkikv", "wzrslvjkrqsgdclqsthdsffrgkqpw"]	[373]	TODO
"cnfuqmrtwtnhysmneyikvmnebzuwicurucbzktzcioglzlqwqeajcncaozwyzbjntlohuwbjmhfvpnuubuoadvhufcxxtaztlqafszicmvlwroatregobbqegfygfetgyaegupistumrrnwxgqlaizwcqjtvriymgbmjfjxspbynykzvtvoienryeqcpxlrdvkiaydetxamjupemcujefbhucaqfydmrijrlisudefitbomacsxoerifcekmyshurgewfiyjvlzogseihnyxkmnzgfynzpdasmwhjknxofushcnkuqtpbmfhibpbfjbhsrmxbesfjwznxosalsovqzewuhirnttirmdtckfjgqexnuxwwmmepcvwbmoyjonhrharuehmpxgrtqfqztydrrpikzlyddofwdpbnonruydmklbnusbzysboenaybfbiustdbmpnwjeaswnrupaehbmqvmuoimykqyrcdymsfgsjrihzvziskznfyejncesqavdqramphidcqqajciqbgkwpitrweyswrmsxmimnxtlpqnqwmocnqereeepmagatlfxesgbjaywqrfohkssazldrazhzkkzfrrjlclfcqnwfanquimmbxacxjbrvlaazimprebxppskscarrmhcbhiincwrjqrvezcvrajmfxskdsgsckptulqejosslltascsygqqoomqurirxanxldsttzsssisfvyhiyteapcrqqddpdajgwqaqgfmpvrzgmjrdjvqdyfpjlzwbuthbqkrwqjmmayundzbierebphlimbcfhbdiupxhdbnwpxjjrukpzqfdtcfmaochfobchrbiisdyjixhkienxjhekdgjjincppidmtskvuoxjlqnksrixcogfouipdwbkexvemdbslwxefkrhgwctytsakpprmsbgmsfouekovtjzhhjzckhnhdnlztkvsmprqhvzqfdlotvxhxiactvbfryrrelycqmqtwcwyebafowwudrjfmnukwzgnvnludhkpbgixhgnexhgvtuhjflnypywgrkmpuoaysghetvlxsnzvejxmfbxzsszndycattyocoucgefoaxhxcqbptwxvnrqamqhlxoidhhobqzxqcqoqoelpvaaqcicmebfyevzxfwintourlqdtphvtksqkvwvhraovvqjhsbspfwngebthjvhntcsnxtssakavtufvnzggtntoptdwnrhmqxwsxuhwyzuyviiqbcrglioqqmfkhxvcpupkfocbdkphhygzmqheeepvghfhihblvspabybwefcxgirmwggnxvidsswvxqwznujvxluytjhckgkctzledjluqzxpavdnwiqsjhczlbhpannbowdjtbpwjumjwgefcvhkfhnczpvurimneadehzvmvwokqkwwdttmamujrxseeqhucwggtylnjifbhnrqnrznkveazkxiaihcfzifoktrhecjgqblfkwrfncrfewepcfkbowfqqpcynkvjjrivoxhgfgdmxniethdprlmdqubuyovdnlkghubwlxbazgxbbvetwgxejrtdyvlwrprcqtdheqjrrgitvotuseixpinilwdzmobhpquhesgvsivtynkaazxpgkymczvmxonkydnajlsxktxdntdnbvcbdnydsrtjvmnraxcjbygmydaqxwzwjzitpmfgksueiescyvkvrkwlcrhffmniymqgoyarcmvigawnvccnzedbsrxhhztfvwegzxihbmtaywpcdnuibgcoiedgrfeuyllfakxhoxhtporjckbtjbfhwuzocrclzjczndjgpycaarmabltlvfykrfrryxjfgkwliayyynyvudvmbvesbhwtqewuyainjdqbdkskscfqehzdfwuxthwqxpazstoxflrmplsamkicugocrcewgnswcftposuzrzpysgyqzldvmlnhmbcuypbnhaixskrylyqrnuxfovhtrvahpaytpplepulbyksxelebelejwwzfujdrjkrxezykvwmigqefkuerenaykjbpyqmxtjpoyixifbxeiyjawtrnncrshigfdnmfowktftimhectbjaqjtjorbbachfostuzdyklyadpddpqisebvrflixlqigyycesehwbfqxzsvemmjcyxxbafrvvxyrkypwheszjmtnqnbzwuajaqmhvksiiaqhpliotnqueqfpjxfaaduasfhgwecxxdqkbeqhbeldygjxdixdsadzfrhvsgjjwbvqxutriusnjqztdrfuilnsusawsjblmpkbqziwnvkdlmdbhmnadweglxwctqjmlyyzfliaqadknnjsxoovnuvxtuftacmlndstavtisxaizjycwalzurcubpmzvooqubxlfwkhvkgevnsknrndwugqruturozzdcvuednzclwlwuokkarclidjzdoamdzgoejmmoyutuodpkrxkxfsfnxxhuqygcnofoctjnkzfqcktxijsoqhcpibrevifipuvnkxwyrlkxokssnabjkaqabfxsvnnafinrohmpssubdrozcdlbdkzwwrlmuwmcxxxlrbiyozslakvtrrgfazyraxknssujubezhpfdfhgeupoknfwvxznrcfkyzpxvsleeqjnpmlkeiqqjnswkxhbfwmbtwwnmzbgalloxxxloohrgdeznquaosbpmctehgfhlceadyyjaohajwjespxbbwelxotrffcgoebjhvpzgfzuyltciebtpwlkmngttgtsdgqwsmtpibrlprmypllazwkyhunajnftlydrweydwmgmhuxedheqrcmczxaybdyvzbniwwsfhoiuregowdleodownejpmftvwmmohczkvhplqvifzmuwtifypqirpqujbewjfgvhztvcnmsooryfdggzwrajenpwblgempxpyzvistyzwqxprddfsxijbnahdbqaopptxcimtnywzjugigevdpxxcwioieeyjhvchmuheerirzcqzsmibadgrsfdkuhvysyoieeslonuwuatrmrtnogkbfimcaxnshanqetzumnhfvayqcvkvylfbuitudyrryjehzrvskskdffvfafhpawouepsntlkyfifrdaycfoeujhcmwhqwrlhsidirbzmwbiortaqfovtqsczlgchrjulkgmbaplwsmnymnjcaecijqgsqgffucgyilvcqqxyzkiyfbmfdksibfyrobpqbsjcieixpdkfrbayknhiefqdkupqyafvsqyvpnugapecfenqavxezpmnrrkjcwxyfktbsuhfxwplvikvnizolptjmhpuckdpvdftcqedskbthjppbfaphtdvhkxgyvvrkzibcpqpeiywbtmzondxylzpocpblgtpkqfblpsblaivtzoopjutepvungmqtuljhauspioitymtftszjrhrmfkwovfowgwtbhvftbvivrqhwnmtjvioaanostzmaijbtxdtwkiugwlqhdrmzdtzwmxulcfyriviokqnvdfpygmodhtirigojwisxocoyvybdkyhchdnzttihixgxqfcsvsubpipcufdpbryzpwmpdzestfmxkmmxqfwlvmldtgkaqezmnpwzxpeebaylmwhzncvqmwojxqjfyvircdtdzdnmdwftswzteoqcylzkklwowdpwvyyebqcxfoxhmraapcctjhhystaldpbhgoralqrgnskxvuqgzxcnibrngcxdprrvneswvlwitcevzvynjnxbyfspomjakhsewbvuvkkvzqinmlxpwpeuzjqdogqxbmyiyikthynlmlwoxvzogrqhhoreffyxcrdnwcmrlwzdbijrnynymzpnwyblgoztvqlkwfgbljxvbamspecqipjfinacgziygkexwdikiodaetfjdpgsaukidkqenealixzdygrufsluscskpowpqtvphmkogmtrgbpnayxeghtohvrogohrpsndiojrrzximmumwagqhglkyzqvxcnuyxgnlkkjychdkyacyawogbwpmsgbplmgzmlsspwgvcxdnwewrnnivkyxqyruqhjgvsfbhlasmwmeocvvmqmqgxowknbasmagifhtgholcrasqvtzmucuasbktzupplslgfmawclwxluprjezsfvsjfwzxgdulkomrcldixyozeztcrzypfgdkxctqokkrqsxqcneewmrypwmmcqrowsxoyxlatorxboobgjwwoojampmuuhqhdoezuakkebgdffqfqsyybfyvzwdytpofhurnugfiaofxkynacwvglcyvwzcddvlqdzzgkxcjnsgfglfibhcvhnirfipumiabajhutasnsptpqfycqylirmwyzmdpzdsjcxpcxglmouwlcjldfxfvglchdodrluhjtekeepckqxodatvfdhhxsarkeobtqkjwqvvpcnxwznszmarahgwfgeqxkretbiwimjlmozhwpfcrfxiqdfnwmjvvzzvkgjhnysxaeqrhpxczprgkpngweyuwfxadghavfqsmelvkzvlfunwwxqovurkifksomsbtnougtdkbkodvcpuxmqzsfnnuoiicvccqsjipgafzeuosrqmhdydlqbfygvnsvumtpzpvjheryjvjbxnxjbzbhqvzjiexhawejjzvnqlqbrbhevcrphieinrbmpinpfhdqjkubfahyzmaokchurqhuejshbgexbnslowyjrpftwxfgfdjvpndkdmuqutsmmafcrghxoxempmnbgeosalwwfgsrgakuhwkgrudnayxodbxxxumqeasmbakazlmjksjgrtyilkyhuhqavkqbknvuvflotdihkzzabstpdlogsybaoczwuobxknlhbkummnmntjrdevwjrqjyxljtcuxzdbmqjshstntidrfmulpzzwscbxcatezxdyptcoscaswdlvaewoqtmnrlhrvhvoqkbnkacxtcjweekeuakhtspitednqkcflttpbcugcpxskcuycpfcabrtwpmsxukamkflhcmbnbostiacndcvqxnsmxagtjhmvdfseteaamfazdtolrgkfydihqizbtypdahmaxnagbbjxbwzirmsjbylrusiucycgpkameaudbsvhmeahaenbawtluiouusjrwjhnlyhvtoemkxvulqmlomxizlhyrlmdfnacwjvwwbagwvuhufpicmxafrpsjwkqkuqtvjdulqubjpjvzqmazhzxcfmkvvtfqqfjbnonzqsllqivejowmdpuurywmvnzjaynntxoxmghkreqhkoyrhezcbcuolnwyqhiqcysuvdyumjnvrrlgsoiesjkcetmyhzjbeqlbsxyrgrlixwrjmqiqbawdaakzuvuijogqnvfyuamawkuhahtbhdwjwclglecfjcnelbhdzvdtegaxbaqudfvpprpivnsxuiydgsyhtzaezhnuhjprqgluqikljdhofsmfhdwhqiwgtkuznxazxyvoudtolbhgeneqhyitudtuckvltpvxitmjfmwcycgalfipgrymolopobqssljpuodiiprunqnwpmjvhfrdavzopgbamnpegjordnkhufrqiajgdhedsrlhivhkqeiqcydercxzpfcndjylmhhcgpgrczbqrcexmmyzmhuwwukyvoqxetdfyeslwoheoxyrbqalinkfflbhciqfqpmjkqfaydetvbiortcqnbvavshlvcajvmpdzbdfqlemvpiupraitoinbgqptqwvzlhlvicuusfdbvgolhpueyednyjnutinubdxcoazkdijjrrscmqsxpkzinfhyvseouyvipeakplnlztjsxrjkgyhvgurswsbbtftpjtxquzkphngquubuejwepojmbunbrmezmlcepbhopzywnsbgwqdmyiosjcfaujjefkuzjlwqvufiwxroofrtvyvenhwxnalgjokpttuvkcmcfkozwnzmwfgjwqczrjkarlpwurkpxvpydasvnwxjydyzpnumopnncrkzelxvrkrpkygszwxsvkdgsglzodovoxemhlxgpsoxgsuzmaxqjvrqsztbioppmkwvfsvbhgqhohmrhgdnvputdubsqshzwrflvapsblffyisotkandlnloytlgaoxczzljfilgscvpybyfzrlvkegeeyfetnozotljqxklffqhwuwibblmwmcywpadceipfudnttwosfxurvztpsjjikfexxnelukcornswkznirdwuixxnggukftimnodfxdkohwnuiqhdptcyxdqdehcmhqovllzbgmdbhhntcofvporkjdccrrjcfrngzphkrrjctdrcjpydhjcngquqdsxlnzlodpwplavldlmtqddttomcvsqhbpvpdralmriftmgdduescmvitxrnmfvyztiqwgkbiaxinxoatusistqsefiamyyylnmhlvjupczrfwiegvpoylhhgthuyfdwttclnhocbwrdpwmvkrhozkwhkcvfphyyhnqsvnvpkujdbokjvuiepfrdpulblqvpzugedphrqyprawbpgckpogjajszfnfzpczheduvpxanwwymqnslgsshqhjyvqscwxbnylcthgmrqqkojxcjmpmbfpshmzhhczpmsvmeyfskvqqeowrruhtcfpgtdzaono"	["wintourlqdtphvtksqkvwvhrao", "wplvikvnizolptjmhpuckdpvdf", "lyqrnuxfovhtrvahpaytpplepu", "audbsvhmeahaenbawtluiouusj", "pbgixhgnexhgvtuhjflnypywgr", "rvneswvlwitcevzvynjnxbyfsp", "bkexvemdbslwxefkrhgwctytsa", "qxetdfyeslwoheoxyrbqalinkf", "lbyksxelebelejwwzfujdrjkrx", "ixgxqfcsvsubpipcufdpbryzpw", "jfgkwliayyynyvudvmbvesbhwt", "xczprgkpngweyuwfxadghavfqs", "ihkzzabstpdlogsybaoczwuobx", "mfkhxvcpupkfocbdkphhygzmqh", "gwqaqgfmpvrzgmjrdjvqdyfpjl", "fwdpbnonruydmklbnusbzysboe", "runqnwpmjvhfrdavzopgbamnpe", "tuodpkrxkxfsfnxxhuqygcnofo", "ezykvwmigqefkuerenaykjbpyq", "mxagtjhmvdfseteaamfazdtolr", "lhyrlmdfnacwjvwwbagwvuhufp", "msxmimnxtlpqnqwmocnqereeep", "knlhbkummnmntjrdevwjrqjyxl", "mqxwsxuhwyzuyviiqbcrglioqq", "ndjgpycaarmabltlvfykrfrryx", "dkqenealixzdygrufsluscskpo", "itvotuseixpinilwdzmobhpquh", "jrivoxhgfgdmxniethdprlmdqu", "kmpuoaysghetvlxsnzvejxmfbx", "ldrazhzkkzfrrjlclfcqnwfanq", "phidcqqajciqbgkwpitrweyswr", "vhnirfipumiabajhutasnsptpq", "mzvooqubxlfwkhvkgevnsknrnd", "mpdzestfmxkmmxqfwlvmldtgka", "iqsjhczlbhpannbowdjtbpwjum", "akkebgdffqfqsyybfyvzwdytpo", "dbsrxhhztfvwegzxihbmtaywpc", "neewmrypwmmcqrowsxoyxlator", "qewuyainjdqbdkskscfqehzdfw", "prpivnsxuiydgsyhtzaezhnuhj", "ihzvziskznfyejncesqavdqram", "baplwsmnymnjcaecijqgsqgffu", "pocpblgtpkqfblpsblaivtzoop", "ctjnkzfqcktxijsoqhcpibrevi", "ajwjespxbbwelxotrffcgoebjh", "gkfydihqizbtypdahmaxnagbbj", "aynntxoxmghkreqhkoyrhezcbc", "fhurnugfiaofxkynacwvglcyvw", "gqhglkyzqvxcnuyxgnlkkjychd", "ndstavtisxaizjycwalzurcubp", "cfyriviokqnvdfpygmodhtirig", "egowdleodownejpmftvwmmohcz", "itpmfgksueiescyvkvrkwlcrhf", "hkqeiqcydercxzpfcndjylmhhc", "lixwrjmqiqbawdaakzuvuijogq", "omjakhsewbvuvkkvzqinmlxpwp", "kyacyawogbwpmsgbplmgzmlssp", "qrcmczxaybdyvzbniwwsfhoiur", "rajmfxskdsgsckptulqejossll", "xbwzirmsjbylrusiucycgpkame", "uimmbxacxjbrvlaazimprebxpp", "tqkjwqvvpcnxwznszmarahgwfg", "euzjqdogqxbmyiyikthynlmlwo", "mxtjpoyixifbxeiyjawtrnncrs", "ucwggtylnjifbhnrqnrznkveaz", "xhmraapcctjhhystaldpbhgora", "fdfhgeupoknfwvxznrcfkyzpxv", "wfgbljxvbamspecqipjfinacgz", "gpgrczbqrcexmmyzmhuwwukyvo", "bafowwudrjfmnukwzgnvnludhk", "ehmpxgrtqfqztydrrpikzlyddo", "xodbxxxumqeasmbakazlmjksjg", "cfjcnelbhdzvdtegaxbaqudfvp", "jweekeuakhtspitednqkcflttp", "eqxkretbiwimjlmozhwpfcrfxi", "nkydnajlsxktxdntdnbvcbdnyd", "ydlqbfygvnsvumtpzpvjheryjv", "tskvuoxjlqnksrixcogfouipdw", "biortaqfovtqsczlgchrjulkgm", "zwscbxcatezxdyptcoscaswdlv", "prqgluqikljdhofsmfhdwhqiwg", "kpprmsbgmsfouekovtjzhhjzck", "zdbijrnynymzpnwyblgoztvqlk", "zsvemmjcyxxbafrvvxyrkypwhe", "fimcaxnshanqetzumnhfvayqcv", "nvfyuamawkuhahtbhdwjwclgle", "wgxejrtdyvlwrprcqtdheqjrrg", "vvrkzibcpqpeiywbtmzondxylz", "pjvzqmazhzxcfmkvvtfqqfjbno", "kxiaihcfzifoktrhecjgqblfkw", "kvylfbuitudyrryjehzrvskskd", "qlqbrbhevcrphieinrbmpinpfh", "bcugcpxskcuycpfcabrtwpmsxu", "dnuibgcoiedgrfeuyllfakxhox", "hvrogohrpsndiojrrzximmumwa", "ojwisxocoyvybdkyhchdnzttih", "tftszjrhrmfkwovfowgwtbhvft", "ekeepckqxodatvfdhhxsarkeob", "jwgefcvhkfhnczpvurimneadeh", "vysyoieeslonuwuatrmrtnogkb", "fqdkupqyafvsqyvpnugapecfen", "basmagifhtgholcrasqvtzmucu", "qavxezpmnrrkjcwxyfktbsuhfx", "tssakavtufvnzggtntoptdwnrh", "hnhdnlztkvsmprqhvzqfdlotvx", "qbptwxvnrqamqhlxoidhhobqzx", "jtcuxzdbmqjshstntidrfmulpz", "akvtrrgfazyraxknssujubezhp", "isebvrflixlqigyycesehwbfqx", "xvzogrqhhoreffyxcrdnwcmrlw", "bvivrqhwnmtjvioaanostzmaij", "tascsygqqoomqurirxanxldstt", "lmdbhmnadweglxwctqjmlyyzfl", "robpqbsjcieixpdkfrbayknhie", "wpqtvphmkogmtrgbpnayxeghto", "wugqruturozzdcvuednzclwlwu", "fuilnsusawsjblmpkbqziwnvkd", "zcddvlqdzzgkxcjnsgfglfibhc", "melvkzvlfunwwxqovurkifksom", "fipuvnkxwyrlkxokssnabjkaqa", "cgyilvcqqxyzkiyfbmfdksibfy", "ytjhckgkctzledjluqzxpavdnw", "ffvfafhpawouepsntlkyfifrda", "fmniymqgoyarcmvigawnvccnze", "uxthwqxpazstoxflrmplsamkic", "vpzgfzuyltciebtpwlkmngttgt", "yjixhkienxjhekdgjjincppidm", "qdfnwmjvvzzvkgjhnysxaeqrhp", "vsfbhlasmwmeocvvmqmqgxowkn", "ehbmqvmuoimykqyrcdymsfgsjr", "sdgqwsmtpibrlprmypllazwkyh", "htporjckbtjbfhwuzocrclzjcz", "wgvcxdnwewrnnivkyxqyruqhjg", "magatlfxesgbjaywqrfohkssaz", "bfxsvnnafinrohmpssubdrozcd", "mouwlcjldfxfvglchdodrluhjt", "rfncrfewepcfkbowfqqpcynkvj", "unajnftlydrweydwmgmhuxedhe", "kamkflhcmbnbostiacndcvqxns", "uoiicvccqsjipgafzeuosrqmhd", "bphlimbcfhbdiupxhdbnwpxjjr", "iaqadknnjsxoovnuvxtuftacml", "zeztcrzypfgdkxctqokkrqsxqc", "dqjkubfahyzmaokchurqhuejsh", "jutepvungmqtuljhauspioitym", "skscarrmhcbhiincwrjqrvezcv", "fycqylirmwyzmdpzdsjcxpcxgl", "rwjhnlyhvtoemkxvulqmlomxiz", "esgvsivtynkaazxpgkymczvmxo", "hxiactvbfryrrelycqmqtwcwye", "jenpwblgempxpyzvistyzwqxpr", "zsszndycattyocoucgefoaxhxc", "yqzldvmlnhmbcuypbnhaixskry", "lbdkzwwrlmuwmcxxxlrbiyozsl", "szjmtnqnbzwuajaqmhvksiiaqh", "zvmvwokqkwwdttmamujrxseeqh", "gjordnkhufrqiajgdhedsrlhiv", "irmwggnxvidsswvxqwznujvxlu", "higfdnmfowktftimhectbjaqjt", "ycfoeujhcmwhqwrlhsidirbzmw", "tcqedskbthjppbfaphtdvhkxgy", "ewjfgvhztvcnmsooryfdggzwra", "ojxqjfyvircdtdzdnmdwftswzt", "naybfbiustdbmpnwjeaswnrupa", "kvhplqvifzmuwtifypqirpqujb", "buyovdnlkghubwlxbazgxbbvet", "btxdtwkiugwlqhdrmzdtzwmxul", "xboobgjwwoojampmuuhqhdoezu", "uolnwyqhiqcysuvdyumjnvrrlg", "jbxnxjbzbhqvzjiexhawejjzvn", "jorbbachfostuzdyklyadpddpq", "vvqjhsbspfwngebthjvhntcsnx", "itudtuckvltpvxitmjfmwcycga", "zsssisfvyhiyteapcrqqddpdaj", "qcqoqoelpvaaqcicmebfyevzxf", "ugocrcewgnswcftposuzrzpysg", "btwwnmzbgalloxxxloohrgdezn", "zwbuthbqkrwqjmmayundzbiere", "lqrgnskxvuqgzxcnibrngcxdpr", "xnuxwwmmepcvwbmoyjonhrharu", "eoqcylzkklwowdpwvyyebqcxfo", "ukpzqfdtcfmaochfobchrbiisd", "lfipgrymolopobqssljpuodiip", "frhvsgjjwbvqxutriusnjqztdr", "muheerirzcqzsmibadgrsfdkuh", "tkuznxazxyvoudtolbhgeneqhy", "eeepvghfhihblvspabybwefcxg", "quaosbpmctehgfhlceadyyjaoh", "nzqsllqivejowmdpuurywmvnzj", "soiesjkcetmyhzjbeqlbsxyrgr", "sleeqjnpmlkeiqqjnswkxhbfwm", "cxxdqkbeqhbeldygjxdixdsadz", "rtyilkyhuhqavkqbknvuvflotd", "geosalwwfgsrgakuhwkgrudnay", "okkarclidjzdoamdzgoejmmoyu", "iygkexwdikiodaetfjdpgsauki", "pliotnqueqfpjxfaaduasfhgwe", "qezmnpwzxpeebaylmwhzncvqmw", "dkdmuqutsmmafcrghxoxempmnb", "aewoqtmnrlhrvhvoqkbnkacxtc", "bgexbnslowyjrpftwxfgfdjvpn", "srtjvmnraxcjbygmydaqxwzwjz", "ddfsxijbnahdbqaopptxcimtny", "sbtnougtdkbkodvcpuxmqzsfnn", "icmxafrpsjwkqkuqtvjdulqubj", "ezsfvsjfwzxgdulkomrcldixyo", "asbktzupplslgfmawclwxluprj", "wzjugigevdpxxcwioieeyjhvch"]	[363]	TODO
"mmtwejmyxtzzlanjlgdyhhywqldfdqujoszelnoxpqctwoopamvlgfmeffvvmnsmhpjhphjjwfbsszgnrflklduakctlozmenvzmpsvfoqbeaatgnsenqhffsvjtqvkgyyccritohpdlkqgzunikfppbxbpkgnhmjewjxjjykcyfjwmgmnsgdifejkwwiqhdljcwuhkctttbjyaigntcqbtmyjspwvawhssjcxhmsvxlfiiuqlosvtjsvlincdmekjcgksvmpnwiqbvevkkixeuoevndumgzkysfrpgddblliveygrdkfsibmkxeokxktjphbbqmikmfjalpgerwvkllhxshbyxpxegrdeprwfazrylkcrcivbktnxkbibwbmbnfmpyhirmvimjydhtudrsdpxxlodomubiewdkoslkrwdihzlalxndeufsuvttnpldseutzuxctsykxjtmkdjrsuafcvbvlbwfppvusonqejfjwkvbuenfhfnsevmhieblqkulkrqwqxzboyzrlkyadjbgsrluhowukpwfecqurhonniunaghbwdhgsazcaolpppzyuhixviwbhmvovtvrqtiuvfrshriqpfdtonavqkqwojxvcocjpyixxiajvmwrqahqjlfmimsiiafqhhdquozmidzajlydaucrrhtkyihemnlifdejdmznjjaugutxwdpdijlddfijaimoljfeitepobejlqkponfijjovlihfhgsamobndmdmxgixehtdhbonsobegdcxoegxehugiezzljnereqfmyajyhndqoeqdrzgfodmerreqlqzstmynzmgwpncwsjassuothxqjwnmminyupprrfkmiiwcrzsawjhjnymavpilliyulbmrtotuqfnzttdfbzuzepdxjlxyikqzqczncurjyrtceqsdsfrkzeoeeuoxvqnjjkasbglhqesulbtfdhpxzwfmpfsxutqirpwnvxfjjvygqnrlsdwxagszxkcmxynpvuwidgmcabamvjdmchshlvmxjuskqhnayxmbzsvdtdjmczhvmvpmghspybndpczvunibsawibioifeagwvcvttxcwrwflltwourtqmufnupshvuggnaoegcfkllklsolfnswwagxyoynkqqhqwhlztjfsydhnmhfwbgsetjltmrrcijjbngqdmmgzfrvijeosrevhnzkwvbrjsqfepxyatdevswyljyeyopnclilbyxsnkodrlojsdcdqxbqqsumsdptelsmyaqapjbdgbcuxztzbpaaigzrcueprkfitmmavxbhnifujbosufokuzbrvdebuvjsrznbnztcjzruglazjhaimhkuiuozoamnewcslmdjreqkhwfrqrkohfnmgnljjmycehptiyoilqhavnjjnehfvsqfekubogvtxxgvqgakpndxovgcxrhlhxjbbyikmfrtqkmthqukievgpafhjnfrulccygibwvpvjswrxtkvqghnxneqcvznvkohegdyhfhrbyrrcbbgfeyydotpvudqcwumzhbpcddvosbvtzhzurhenkqvcofkujlcromcwfzucyomhhlafaofdydwfknjerasoiewmutwkphwgagunjjpucfggfpnaisafkqqvocgpdkbzhnknyrxhfkrolraihnppiolgvgcuhkcbzgbtgnkwkbuknyafgvqdkknaebqvgjqsmaicaarpsmrhbgbhhazmpvzqghfplwimqhwwldfsfyzsdgvkmqohhiwxxqhmvxsfjjqycmnekvilaykidkmihtcyntzbamtuvrqqmiulfblnszikycardsitzjwdkaeyjutvksvmmbwqiofdzntrelsxajstxznibdayiebnmrgnnupkxyvfqmqpvxaccfyzzwhfyphzdxvpdllsqcotuyaniuoggyfsicbdmeuffckknvmiixnbijchizrteakxfqegnawafnmfzswjfmfpvsqawibadyqiplsdyjkxfoytsiconhmkvbpryuabkwgoplmcyolxojaetfedbjukeeklhtbmjaxbyskwekeeecikeundgxnrfzrouoxiatjuiedruihfymmcdppotdrzrxzmxccgmazobxrnbfhhgisncyndonxowbmdvrnnjvchnlsvhvtxyquftlvprcpmvsjgaayxtjjdyowlvhmeuecfhqzfgrkhhdrlzqmxdifbiyoflxcwazioajexyugutguwepdiliaieapeqmywoduavhqhjdabngutbtnoujghxcbzuhouznjqfmuujjofwrbueclahilaqbeiepzxdsbkqczwaziqcjvpscvcyvfdqznulvmdpuucnoxjkvdgtucznzqgjucdbotoiydoqhcisnpxzavwqzoiagexztsimzgnscnrsbzzcucigkbdyvlwheddqinofynbjooovzqibgsfhdinuzxyxhbbxcvqjzjwkjujtvtwfqqnlhoumuksyqpijrhwbrtyqsmnpawzpvkptisabxchbmmfdggxioieeceqfyhqfpczltdbapdthjbixhcchqtzgqarplizmqjmrcuaxhcyokexpmlgbtfhlljtltrdrqaraygilaeotqraoxmzfkdjkcbimnnmqftpxoluatuvrwsneyvvdxeulpzpdzaopvwtvxftagxjzfyuxsnfydagydboxevtwrirppevbjeqllkwhiglrxgihjyjcsoxaiwioaavlcfundpsnchrlxkhgtlazoqpyvlyeyfhjlyfdbodketkhrmxsmiwmefzmfsgubrgviuujrheskxcvtumykhzubyesnnfcurikmveppqqobgvwquvfayghwozmctrohkkygwcvvgvkdiclzzfdtukjlyzocvbdgqomvcuqfnsvqtvhuezfaynfwvflgtetreybpkazioyhpfotvqkdpzvhydadqbqimmghowpquvutpnixihflddhoglddbcrxuiyubvkoibtlcluyfjqkbxijxnbobcxlyiraybhpzktqzstpnorcxkhpqdpymtjbuqtiyvotypreqsyisgqasukrslgqtpafccwhqwvthoqwttbiladsqrarruzespcpmlkopgpqjcvcdkqptcgoowrntzsiudodekwgefeosxvqofcmhjxeiwsllzzuuqtafjxblhzsgqlgxnvyylodxeemmupdvgvewlmpanqmgqzziyepjeykinobrpmobudurhdjfoixqjnexsqkkdjfpasekqegigikxnegcxvgqzovpqgroxapinqaylxdqzubkafqqedsmdmhnbhcrlwkovpybtoaulhcyojpdbyhxbbuidlvppjpxvvnmkjdvopsbvqmqtgbwanczniuddssumsdoogkoowbkvlfxgdexptodnugthlfgsvyehsdhguxhwqgzoloptoyelmqhpmuilkrhxevialmqqbagbhopefjskdcrhrihzkcowziqbctavzmkduoqgjrhcohtlxzzokiraszetromcucppccbhoesczqnnakbpfnvovptowfvthljsnfcozdcgobjayfkxhjlpzsmnbldeubklsglpbcvbketsvrftgjgsovhvbqplyoungupfnrezfqxdzqqfdevdmpwrnergdwgnpbfwcvoejxiszhvxzienlauobwgmtpmjuqzrfkfubwfqyezsrmhlkflyigvuvlinkhndwheugckdmjqpkxtjysuennhbrxczgorbsfcleidgpnvlumjkjiwykyhbztihdkdqdwqyclmmrudmtbobgwhtvopjtcryitpoanyslzqrccmmkmxetgkxgokovzjarbagbuubckczgwretwkgbfvfsafmdlkscpukdwypbjljqxoreqkmxjkjxmvhpjcxvoowwysuxfybyanopimhdonfxkchdkjwkjtcxiodpymvwxvsclvwlkqwfjyvewouitlbroxdytrkaoxenlynvpxekkxwcxdqadyjdizbrcyjvzcbzhzjkncfiuqqdoevmohfqdtiwntlkwbaqixsgrcsmjlafetkdkmlnyimjnddmubobotfrdvpcckhprwyvhjzltngemnjezfmzvivwarlskhibgeqrnhuthiqggprszppyorzaubnvdkinxenwkrfpvubasnnwdmzppjvdskwkjbqqwgznktmgfxubwrnhmkqadhzkpnfzcxfxvpwggedrjeczfbwkqcmosnkglwhbecrmmwcvywouazbliuktoottolnopfbqebbgliaybskspgsoixtilyrlquocjvjnqhykxwtrguabinvfxxxmiwmepmtblcvktsfagvgmcwxqxoxtlpazfzwzofgoehikcwpjnckorbywvqavnlyfkvtkpckqshetgqbqjqjyymzsoddoecswiicoqqguwnszipsmnlbjmgnunpudxfazphzouslphsnuihekhmdizpbvhougfgsqrxqmaqhnxfrvnsjsqcrhwcdqbhdtrgnuvgdsekefdfemonqjvzrrgtijinbkybbffmvblptpqiayqwmjcmyyydxdmnrbvcetwwwxfjhxpokoulfnmljkequgqxhfuzbmlusfyvgckhvvhpkqtesqrjpzgktiyxnqmexbwvicpaqivfemcvclemznoriypqphrhtmdlxyybdhsggdhatvzubixjeepqvexxjsmknbyddncodeaywpqulvyspcrxpwtbgyjgsxckxbksmmnhaifayxcbunrtxswznzsebexrmbhhxfogpswbyxzquvrpmplxlfjovknugsakossxbgrskvxbgxubewreiqtyedqnimzgqpvabbngkxfspgpyzdlfotxegzstrmlihbptzdofsfbiuweohtfhiykshmihskmzyawhkwnxgvbznmifawbpkqgpbeqducxksdpxhwdxnxnnsqaochwiwbonmgteyhwniexmafsjqeyruxnrjxkqlkidhlylhvompxsvybtpmndeumsqsmtfolituesawtihawpulgtmjggicueedqzmkfyvvotrtufzpqopddaccxgzmnxjqczsheptegsiqbjnyfwckqbivffusgyryearzvewskoxgfumopwionsvhcccajlwnjmzeyoktbbltcptmslxhhovtbzcfkxsddwgoustltdsmaihckgdwywjhlhckjducaqvqxwqhhrqozucyipvdfezhbgpfndtalmwxhzjbcmbkdztlumdygulfztckydtqjhzodebwjkobapoqfdpuetaxyfcpvmbhgienrpwjnufjssmbqfcrzswhoxikdjwntjctzrovxfhabgsywdickvsqousdigdnpweuddcfktrqnhtxinuhbhwbygwtmhehqiflrhfbzyyvncokormbjekmonamsbixgpxqgqyfpwddudruttnoqiuqqybxfapuvhzauhnsjtiijvzoxkvzacfpfseocqrkucpptwqbfejuwenewzmgqqbmlpwnndiuwctfxreysnggsqrahmxwbrebeybdbjelhkagkowmcbbtycvluopcrqvemqgrwruqzqtayjkjsybrfqxaqefqudldniemkaoywpxkzbephwdcvsfavowbppmdljfvxfsdqauhesibgnzaspldmwxafdzfctdrzgthmhcycyhagmlufrtqdawizlwitfkuwxjeghlausuiqxvxwxzhglxhltmsblalmrhzjsegbssaamykshwnftfjiqcjqsgoaxiralqefxvrefzknlzhspounciidsybfdcnegevvpbwzgbkqgxrcxublbaedwmkhwzvzxgyhhimxgcztubmmllmbygxkvopnqrvbgftxpytojxmgnscrfwcrzrbqrxizwaqblnrtjsmryskjzyydkjsjqmmksbajhwhhmjiionvaejxmmzfnevauuivfgdulayaqudeuppgqbvvljdnnwjrppvicuvcysftfiqylnmgzuhbgzvqceqxqfbjgqadrljjidxzmssrfccxgzzymazorghqdlnelanzbuaxjnwuvxdacuwuyoryaftbjddybpeksoboorrvwttufjplfdqrvnbsdmnmssozekkdbbuupfwqlhkjisjjhfoiqcbxeboiyknayxjvyijqxdwbkisxptccdvrgg"	["urhonniunaghbwdhgsazcaolp", "mrudmtbobgwhtvopjtcryitpo", "xvqnjjkasbglhqesulbtfdhpx", "pshvuggnaoegcfkllklsolfns", "ovxfhabgsywdickvsqousdigd", "icueedqzmkfyvvotrtufzpqop", "xfybyanopimhdonfxkchdkjwk", "nyrxhfkrolraihnppiolgvgcu", "rfpvubasnnwdmzppjvdskwkjb", "iiafqhhdquozmidzajlydaucr", "ioaavlcfundpsnchrlxkhgtla", "skdcrhrihzkcowziqbctavzmk", "amobndmdmxgixehtdhbonsobe", "epobejlqkponfijjovlihfhgs", "fnmfzswjfmfpvsqawibadyqip", "iyvotypreqsyisgqasukrslgq", "iebnmrgnnupkxyvfqmqpvxacc", "cjpyixxiajvmwrqahqjlfmims", "fzucyomhhlafaofdydwfknjer", "sdptelsmyaqapjbdgbcuxztzb", "updvgvewlmpanqmgqzziyepje", "nzqgjucdbotoiydoqhcisnpxz", "anyslzqrccmmkmxetgkxgokov", "eqllkwhiglrxgihjyjcsoxaiw", "nvovptowfvthljsnfcozdcgob", "nrlsdwxagszxkcmxynpvuwidg", "rmxsmiwmefzmfsgubrgviuujr", "bexrmbhhxfogpswbyxzquvrpm", "ykinobrpmobudurhdjfoixqjn", "hwcdqbhdtrgnuvgdsekefdfem", "duoqgjrhcohtlxzzokiraszet", "nhbrxczgorbsfcleidgpnvlum", "smmnhaifayxcbunrtxswznzse", "dtiwntlkwbaqixsgrcsmjlafe", "nvpxekkxwcxdqadyjdizbrcyj", "jtcxiodpymvwxvsclvwlkqwfj", "onqjvzrrgtijinbkybbffmvbl", "gibwvpvjswrxtkvqghnxneqcv", "gilaeotqraoxmzfkdjkcbimnn", "znvkohegdyhfhrbyrrcbbgfey", "qulvyspcrxpwtbgyjgsxckxbk", "aniuoggyfsicbdmeuffckknvm", "kptisabxchbmmfdggxioieece", "qptcgoowrntzsiudodekwgefe", "frshriqpfdtonavqkqwojxvco", "azioyhpfotvqkdpzvhydadqbq", "zzcucigkbdyvlwheddqinofyn", "pwrnergdwgnpbfwcvoejxiszh", "wxhzjbcmbkdztlumdygulfztc", "etwwwxfjhxpokoulfnmljkequ", "cqrkucpptwqbfejuwenewzmgq", "epqvexxjsmknbyddncodeaywp", "zvivwarlskhibgeqrnhuthiqg", "eundgxnrfzrouoxiatjuiedru", "ugfgsqrxqmaqhnxfrvnsjsqcr", "pybtoaulhcyojpdbyhxbbuidl", "tukjlyzocvbdgqomvcuqfnsvq", "mqftpxoluatuvrwsneyvvdxeu", "yvewouitlbroxdytrkaoxenly", "reqkmxjkjxmvhpjcxvoowwysu", "fujbosufokuzbrvdebuvjsrzn", "ddaccxgzmnxjqczsheptegsiq", "iliaieapeqmywoduavhqhjdab", "ptpqiayqwmjcmyyydxdmnrbvc", "gqxhfuzbmlusfyvgckhvvhpkq", "vlfxgdexptodnugthlfgsvyeh", "zxdsbkqczwaziqcjvpscvcyvf", "pcckhprwyvhjzltngemnjezfm", "ifawbpkqgpbeqducxksdpxhwd", "hkcbzgbtgnkwkbuknyafgvqdk", "mctrohkkygwcvvgvkdiclzzfd", "kpnfzcxfxvpwggedrjeczfbwk", "ngutbtnoujghxcbzuhouznjqf", "vfsafmdlkscpukdwypbjljqxo", "zubkafqqedsmdmhnbhcrlwkov", "tbzcfkxsddwgoustltdsmaihc", "tvhuezfaynfwvflgtetreybpk", "rqozucyipvdfezhbgpfndtalm", "glddbcrxuiyubvkoibtlcluyf", "dqznulvmdpuucnoxjkvdgtucz", "jayfkxhjlpzsmnbldeubklsgl", "rmlihbptzdofsfbiuweohtfhi", "wnszipsmnlbjmgnunpudxfazp", "knaebqvgjqsmaicaarpsmrhbg", "ddudruttnoqiuqqybxfapuvhz", "rmbjekmonamsbixgpxqgqyfpw", "osxvqofcmhjxeiwsllzzuuqta", "tzhzurhenkqvcofkujlcromcw", "utxwdpdijlddfijaimoljfeit", "zncurjyrtceqsdsfrkzeoeeuo", "fnzttdfbzuzepdxjlxyikqzqc", "wanczniuddssumsdoogkoowbk", "dvrnnjvchnlsvhvtxyquftlvp", "tmdlxyybdhsggdhatvzubixje", "pazfzwzofgoehikcwpjnckorb", "ppzyuhixviwbhmvovtvrqtiuv", "aqivfemcvclemznoriypqphrh", "tqzstpnorcxkhpqdpymtjbuqt", "muujjofwrbueclahilaqbeiep", "kpndxovgcxrhlhxjbbyikmfrt", "qkmthqukievgpafhjnfrulccy", "ggfpnaisafkqqvocgpdkbzhnk", "fnmgnljjmycehptiyoilqhavn", "zobxrnbfhhgisncyndonxowbm", "qjqjyymzsoddoecswiicoqqgu", "wjhjnymavpilliyulbmrtotuq", "avwqzoiagexztsimzgnscnrsb", "iixnbijchizrteakxfqegnawa", "sfyzsdgvkmqohhiwxxqhmvxsf", "wwagxyoynkqqhqwhlztjfsydh", "heskxcvtumykhzubyesnnfcur", "oamnewcslmdjreqkhwfrqrkoh", "pbcvbketsvrftgjgsovhvbqpl", "ykshmihskmzyawhkwnxgvbznm", "exsqkkdjfpasekqegigikxneg", "jjqycmnekvilaykidkmihtcyn", "paaigzrcueprkfitmmavxbhni", "zrlkyadjbgsrluhowukpwfecq", "qjwnmminyupprrfkmiiwcrzsa", "ikmveppqqobgvwquvfayghwoz", "wnjmzeyoktbbltcptmslxhhov", "khndwheugckdmjqpkxtjysuen", "iexmafsjqeyruxnrjxkqlkidh", "qiofdzntrelsxajstxznibday", "tpafccwhqwvthoqwttbiladsq", "smbqfcrzswhoxikdjwntjctzr", "abbngkxfspgpyzdlfotxegzst", "ayxmbzsvdtdjmczhvmvpmghsp", "yajyhndqoeqdrzgfodmerreql", "ywvqavnlyfkvtkpckqshetgqb", "ardsitzjwdkaeyjutvksvmmbw", "kgdwywjhlhckjducaqvqxwqhh", "bhhazmpvzqghfplwimqhwwldf", "pmtblcvktsfagvgmcwxqxoxtl", "bjnyfwckqbivffusgyryearzv", "mmgzfrvijeosrevhnzkwvbrjs", "ygwtmhehqiflrhfbzyyvncoko", "zwfmpfsxutqirpwnvxfjjvygq", "gdcxoegxehugiezzljnereqfm", "bnztcjzruglazjhaimhkuiuoz", "zjarbagbuubckczgwretwkgbf", "romcucppccbhoesczqnnakbpf", "nmhfwbgsetjltmrrcijjbngqd", "qzstmynzmgwpncwsjassuothx", "xcvqjzjwkjujtvtwfqqnlhoum", "kydtqjhzodebwjkobapoqfdpu", "rarruzespcpmlkopgpqjcvcdk", "tkdkmlnyimjnddmubobotfrdv", "aybskspgsoixtilyrlquocjvj", "zbliuktoottolnopfbqebbgli", "auhnsjtiijvzoxkvzacfpfseo", "xnxnnsqaochwiwbonmgteyhwn", "qfepxyatdevswyljyeyopncli", "tzbamtuvrqqmiulfblnszikyc", "jjnehfvsqfekubogvtxxgvqga", "lsdyjkxfoytsiconhmkvbpryu", "snfydagydboxevtwrirppevbj", "ecfhqzfgrkhhdrlzqmxdifbiy", "qfyhqfpczltdbapdthjbixhcc", "ihfymmcdppotdrzrxzmxccgma", "fyzzwhfyphzdxvpdllsqcotuy", "vcvttxcwrwflltwourtqmufnu", "etaxyfcpvmbhgienrpwjnufjs", "jqkbxijxnbobcxlyiraybhpzk", "immghowpquvutpnixihflddho", "youngupfnrezfqxdzqqfdevdm", "ydotpvudqcwumzhbpcddvosbv", "ubwfqyezsrmhlkflyigvuvlin", "npweuddcfktrqnhtxinuhbhwb", "gprszppyorzaubnvdkinxenwk", "fjxblhzsgqlgxnvyylodxeemm", "mcabamvjdmchshlvmxjuskqhn", "cxvgqzovpqgroxapinqaylxdq", "uilkrhxevialmqqbagbhopefj", "ybndpczvunibsawibioifeagw", "qcmosnkglwhbecrmmwcvywoua", "lpzpdzaopvwtvxftagxjzfyux", "vxzienlauobwgmtpmjuqzrfkf", "tesqrjpzgktiyxnqmexbwvicp", "rhtkyihemnlifdejdmznjjaug", "asoiewmutwkphwgagunjjpucf", "tfolituesawtihawpulgtmjgg", "jkjiwykyhbztihdkdqdwqyclm", "qqwgznktmgfxubwrnhmkqadhz", "keeklhtbmjaxbyskwekeeecik", "nqhykxwtrguabinvfxxxmiwme", "uksyqpijrhwbrtyqsmnpawzpv", "vzcbzhzjkncfiuqqdoevmohfq", "lylhvompxsvybtpmndeumsqsm", "zoqpyvlyeyfhjlyfdbodketkh", "hzouslphsnuihekhmdizpbvho", "oflxcwazioajexyugutguwepd", "sdhguxhwqgzoloptoyelmqhpm", "bjooovzqibgsfhdinuzxyxhbb", "plxlfjovknugsakossxbgrskv", "vppjpxvvnmkjdvopsbvqmqtgb", "xbgxubewreiqtyedqnimzgqpv", "abkwgoplmcyolxojaetfedbju", "lbyxsnkodrlojsdcdqxbqqsum", "kexpmlgbtfhlljtltrdrqaray", "ewskoxgfumopwionsvhcccajl", "hqtzgqarplizmqjmrcuaxhcyo", "rcpmvsjgaayxtjjdyowlvhmeu"]	[529]	TODO
"pnpcortaeddkmlsbtcfwqqfbnfgaogpaoplbrimpovkcvwjuypvtijlvxgqypqkaikdupvlokbsmepqfpmgtcgfepwfpsbakcubcjrfqmuobftzlzcdyzgfzuhweodalgtciutxqivfwcazypsrzwvmzxxxvtrvjustmdmvjhykmzhhzcjmoargrzqgfhmltttbvadajmenxddbztlgfrlaignqrkwsxpaaaciwqapgudhyahnvytwtoyjqdgwmiduhkboutrbkfvtvjrbosccosfdgkxyxmshpbxsszakvgjbiwemrqqqbwyfhjlcnltcrnnalltvkmgsxvmbnjuyqslzjsyhshdoqabqapmmevthqavywxrfxaopvzhjjkvdndysmhiwlyaqkwmckftwjewajrromgcbjuzcthymlwjbenjadedtgpsdronlmgbcktgxqnnkpchuglppmdeomtnlhkskfzarxhbkqxfihnkztkwajjbnejmiqtxklaesjybgvvjlsgzglnhxeycqrqlcpsalvllayrcrgsakwdfwamwluvqotqfnbyttyifvueikthhpbewdqhdblxqikwvhqfqtqbhwpzcnoicqzyxesiysdiqlsnukirpjdfkmaawbhycjzufvbljsgdsqbeuuxsltckbltnbwfyioswwzzgrujvbwfvruozisnuswdbekgaiqdlelqxugavsjbaxigggrwktshwkrtxnalwawkjstafctjeymrtfnjidufpoqphclapzmjvzbyysofycynnuhvknjkhdkdwkcknqisufxscahupldehblrxxecmawxtaqwexbiubqmtzdtavwxtbzmwpgxaujhpgacqdbblujiynvkudqklcjzciwpkkhqfprkmmhdgujdgzlkukhuosolkdlulhbffmrgropelowiqzsbcnvlnwfjsflsnbcipypzayjorkenhtxtwadpdgoiwvkpgvtirtfqesmpkwnrpeuwlwqdftyacdzzhffpdhiberbvtjktczjcngbtjghfyorsxyxtsisnczskbwjvmysztzleuhnlsxsxjfdpqgcruemvoebhfzoqnyrgfxghlwujbwvcsxpceexugwnwmufzxvhuobnjhgoylzsubxmpetlrltnngdlqhhzlapjxtrjitlklpopehlpudegpbgdywsydsriddmovmmvmcvktaqkcaluiqqnhbfbrvsfeiplomyfqwrpdcqwlwrifezepapbwxaogayeurdrnhbadumdzsyonwfndlpxlayggrvwtenrixdouvnyocahvodhvdcyulmzrueuiwvybhzapxzvhtpjhdulynyxtcbsdpcoqxbhctjcmwxqppghdwucpseneotbokgtqhqvwgxysxixjjhtknbimorwrunqzoyexilqylijxyjposttdpvvoqtqbzfmgxkddwjmwdhkeukuhjgbocdbvrcdimrjnnnayelibespiwszkgnmazlqiexykbrjjsromvmpftjqllhkgqpnuxybcvqagcrimdebukwcxgasgxwxikmbquerxaqilcytwfxvrklafavwribuxpokulefoaqyltcbqegnogljnykpehunsxvexlnyvvvyhsgaejssiulzpqzhzyivonxyemafhqlmqifoduyjepkeingufyxxclvqmqwifkozsxgqfddtnxzvmfxdlxdcxhzeamajpbqxkxkrdjsapaqeoqzogslqnzoflkxpukyzkgtpiiztheksonyndyazkkokuvgmndxoodoejgbuvehkqljjjrbicisdnwrbpaqoumssyahwxtcgifimasolgydvgfddjynfhdusfmrsajghxxivxevquenzdbungdmrvqoyoqpkdgadihhdgxpzccmkoiotoufbzxkkigsjpvndlgygivhbpghoplcactiymptoggzimpodgzyjgfkgqrnivkepxbymbcufavqsadiclmukdzlxinghyzhjtlcsenuxuzspsghuynznlzeixazjgovoypyfnssgvhtvwwxqywvpmstnvseepxuvxspmhlvjhczovrnrnubbeljfshdxuqvhbvgavmbxgtvmsuxtnwxqwpkrhprnggqfexosmqlvpyhlpuinagvdgmswnayanmjwtabzerqcqbcqobvkfbjkxpuealsldpwozeippluqbmldlylhijrdjyrryarmzmutkbnkwglcyfzyjbldwvvqbgcknpyleltybrdchdtlifpdvlvmabjihflifyimyoeiqwrrssvghzpparekdupkelxmyizaejeokpqklefhxxhrainfbnbynbcuuppioeeduvpcflisswoalfjwtqqbcrvdbvogxfyfyytlpvsptpamxbxdcgsicoojwzibanrzcszfovfcrjqawkfylunnpuuwvbhwppeulxnjaifqmzcjnnrmdswdhvsltnwneogeyrcwumsdsetnwuwxuhitxkmmvjzlaumwowcxjetjkvhuyohsszdlcrdskuutcipfsuspigjxnuhupdhpukltntdjkgeaxhylmxxadpazlxypdlpqbxyxdnypahbvtkozqygjvnbvcgazkzhcrshfmsxuczjkcvnrbvbtsmumapxtbhbmnotzymvuxaregxphobqojzcrwuuctrgrqjttcukepegdegqsufpfafvtnjkrzfdhxawepfgymlnbqyrrpbvrrksxqzzurunayjpyxgztipllvrrvmgkxfwlwnrvxofvrxrklcntrctrssgydpdtflizncgmxkfawonwlqprvmdyiyroyhephrzijcayayzmzjjzgyteeohzapqwsowcqmztggnnmjkxyqbmisbzyatwzyevzopcfzkbujjdviibxflduwfldizutyylaycjqoqrzthqykforhejadjcoqnhicehuglbtqdfpqkaurbjypvbmrounhtribykfpeigwkdhfutvrerbfmjvhfsddavlbmhbwzfhcidnkaumsvxuhppdlxagawkixrskdfrwqhjuxfdlyihstfiiueyyodnautnqilhlhuuhhwefldutkwobozkwuvdmuajbalbpcahtnddtaqathkxpngwgmsaqvbukrokykrnjfzcjclctketovlnhsfzvaymqzyiebzurddkwdoxlsdoytuldnbelkbghkjdhkwojpikdewttpectihazylzdbubusftzbebbzufxvinvrkuuvjyrjgsqzarrvfdgmlfpcejprerdoywwadebptcwfympprdevkepahpidbjnggocpujygsgbxywxbxndkgmnrevhjzdicnzfdklpzgbbmczlujtaiafulynxwzgvlupdrjdttxlrhzrtkufsjhhxfgpzcdghkdkenjzzpaiftcdxtkxezccozciozxxctwqzkudgpoqnfxniqeaeiplscqpogjljkgbszlwwjfjpuhiwgujxujfnglflxfygbkwtqexgnpggfyubxxwfprtiriirkteeyjbiuwjgwmjaeltcslnprztihvuvhtslezqtmdvjvzblascasqavefcdpmcfzehxxzmnfheyjpjwshmfaspxcudciwmhjgcyhkcerihkisughqkjbqjjbnffpdmojgzslynrtimvqqezlybrtwwlyrfyhgzspdfleiazjsidqzuwkomjtxjczslygajgflidielmtqvpcjgazyrloknqztiusmkcdswvnzhruxwmyuswxazytjixmyhtcvbwohihokolwgmiwiskurgkzywpvrtxgpqmhpkskilujdwgvbfxdqqliulcotuntrzqrhqczwdqxssoafvfzmhfihteqgwjendjqxhhbkzkkainjhikgwrxasnnkyhycbarbjomgkyfneihgovldkxhkmqhezldtrfszxmcgenokzllkvflnuhjizsbdufvjhowfuvbdlipaixnesnqcggbcwmkrddbqccztxnoxvavhvsdytxsjizflprvdfdxmwbzwxgbrntplgmyotxrybopbqrskulpvwwtbupmgtekobgzxiijfeovrgomzvmiixasfambfbujczkespfuejjlizdfqrgpznxoltdhpwucebqtbzkpwdjfunublzbzlwifjjejgthvszhatrbphwlnpcxpyzkycxphpeugknewpdtnsxnnbeqkqkimexeilczpivdssrzsultesbqzpfcdzbvjzlmznszzourpvtxjimugxrcjattdsunahzdirfhwcjqsmglrocevydawosspemzdsfyahlmijjihtqpezhlwbveijnmuzxkrsgqngjzdvhbczbddvdxiecyugecceojnndwonenugjncqzkmuqamazinyrihqmqyafbfdjhyoildfkvcuwqycxhuzwncxvsvoaonzxfkghpkrzojenvqepbjwxhkvhtzxhpbclhzhucpvlvftbbzkmwceaoljhajmzqqbbhyoiowgzaontijrffpoxlafabgdupfohxbbvnfqsxvggahkjhdyeulxaidpikvwwgnivtpotvtowkdgrvtjxtprvdrcxkobxfloglboosrdwhjmlecxzcagbdazlknxztvudglckvzujkijyrogpklblanxebljpofmtfwxyesoakzznkuchujcoeeuymfyuheqmogelwlohaginbrqowrropoacxkdcvxqbgvbsvqcwsrpzdiqsfcyfsktlhrhpaakcqentoglocpkwmswgcqbmspmnrkhimvwjsycydnzwhecknvfktryircrdoyvuztxrnekzqenaggnomtmzfefvqaunzxdmdilzzwdcjzptcheqwbuajngdlzzbrflfqsocbndwxdlhbebhoojrfihsfvayyoptyokkslultcexdycnausvkcjzxbqjqdndnjlmyfdntwmaqgfcwuxctpymkmeuvqqudggmbpwxqpasdomsjtmenubjqpltikgvllhrjvzgrdqfejcueqiwruknlqbiuunuugjfebqpxffnpndeyjvwlmyfjqklrocjnhpqaiqvqwsqyqradkmgpeqvasyqpfteenoxvnonyyaatqkospexhooppbipvvefulfjtjucrpluikjkgcqzfnwlxlloocjpcxybosjwxyrggwlxvwbypnpjtjvhhbutzsskfpuuyvwnizmhepfunsfbloohqlwhsbaukyetrjrfklmvpgxnqljqjrzdrebaptpieeypukfakdkkoqodwrygiwpuyqjvpjnefuunzcxnbqoqfrjbiofytxsnklukytalkpnhceqjotdysekksrdgagangjydezgvzrlplgvyjhvpgmqgljlrivspzxdjboatqreweliuecuzqbckkcexxtxbnmwjutcrsqntqzkapzgdmzppoexywjqycfvdisfkktxsfqyxcniwliqozgbmiuurnxfalhnkkczrvwzxpfkjwsvekdqswrrjzvbzxxnwepnxwjlgsqtwbujekdechphovykavodfobutqfjbzmctisbsqynbyqqrmlghjyeagdfskxbnnjbvpmygechfraafonezuqdkjkwiwcrpsdrszbwjjalbqormfjxndiotxiykbbgalcoajgzaeatakusrlsxggoodealptqrmvquzxvgcwjpcxljssjgqrtxlslpdqbvncylcridedtqttttgmjxfexftxlrgzkoygoscmgqzjlfmtivamoowvjpoprtwchqzlwpduisldfdowhqpsdqyeizehxjtcdfcsxbhdzeyobbiyctywprjiiuwdlpkisokliaguxnlbxigeydovfahgpapxrgdoelozatyarotaeoxshojmkuygjoiwnjgwpnnzrudipahc"	["ukltntdjkgeaxhylmxxadpazlxyp", "rounhtribykfpeigwkdhfutvrerb", "wxhkvhtzxhpbclhzhucpvlvftbbz", "elxmyizaejeokpqklefhxxhrainf", "klrocjnhpqaiqvqwsqyqradkmgpe", "tmdmvjhykmzhhzcjmoargrzqgfhm", "lynrtimvqqezlybrtwwlyrfyhgzs", "urdrnhbadumdzsyonwfndlpxlayg", "qvasyqpfteenoxvnonyyaatqkosp", "ulmzrueuiwvybhzapxzvhtpjhdul", "avsjbaxigggrwktshwkrtxnalwaw", "mczlujtaiafulynxwzgvlupdrjdt", "nuugjfebqpxffnpndeyjvwlmyfjq", "wxqpasdomsjtmenubjqpltikgvll", "unzxdmdilzzwdcjzptcheqwbuajn", "cnausvkcjzxbqjqdndnjlmyfdntw", "eljfshdxuqvhbvgavmbxgtvmsuxt", "jsromvmpftjqllhkgqpnuxybcvqa", "cwsrpzdiqsfcyfsktlhrhpaakcqe", "vjzlaumwowcxjetjkvhuyohsszdl", "ntqzkapzgdmzppoexywjqycfvdis", "djsapaqeoqzogslqnzoflkxpukyz", "zlknxztvudglckvzujkijyrogpkl", "chujcoeeuymfyuheqmogelwlohag", "jkgcqzfnwlxlloocjpcxybosjwxy", "inbrqowrropoacxkdcvxqbgvbsvq", "cwmkrddbqccztxnoxvavhvsdytxs", "pectihazylzdbubusftzbebbzufx", "tqpezhlwbveijnmuzxkrsgqngjzd", "bvpmygechfraafonezuqdkjkwiwc", "ovfcrjqawkfylunnpuuwvbhwppeu", "zxvhuobnjhgoylzsubxmpetlrltn", "jjhtknbimorwrunqzoyexilqylij", "gfxghlwujbwvcsxpceexugwnwmuf", "qesmpkwnrpeuwlwqdftyacdzzhff", "opcfzkbujjdviibxflduwfldizut", "echphovykavodfobutqfjbzmctis", "yzkycxphpeugknewpdtnsxnnbeqk", "eltybrdchdtlifpdvlvmabjihfli", "bxfloglboosrdwhjmlecxzcagbda", "nenugjncqzkmuqamazinyrihqmqy", "cgazkzhcrshfmsxuczjkcvnrbvbt", "kgtpiiztheksonyndyazkkokuvgm", "tuldnbelkbghkjdhkwojpikdewtt", "apzmjvzbyysofycynnuhvknjkhdk", "ihhdgxpzccmkoiotoufbzxkkigsj", "prtiriirkteeyjbiuwjgwmjaeltc", "xyjposttdpvvoqtqbzfmgxkddwjm", "jrfihsfvayyoptyokkslultcexdy", "sxvexlnyvvvyhsgaejssiulzpqzh", "vuztxrnekzqenaggnomtmzfefvqa", "vhbczbddvdxiecyugecceojnndwo", "bjomgkyfneihgovldkxhkmqhezld", "jpjwshmfaspxcudciwmhjgcyhkce", "kmwceaoljhajmzqqbbhyoiowgzao", "yelibespiwszkgnmazlqiexykbrj", "ocevydawosspemzdsfyahlmijjih", "dfkmaawbhycjzufvbljsgdsqbeuu", "kjstafctjeymrtfnjidufpoqphcl", "ivtpotvtowkdgrvtjxtprvdrcxko", "ggzimpodgzyjgfkgqrnivkepxbym", "nwrbpaqoumssyahwxtcgifimasol", "crdskuutcipfsuspigjxnuhupdhp", "dlpqbxyxdnypahbvtkozqygjvnbv", "fyimyoeiqwrrssvghzpparekdupk", "cayayzmzjjzgyteeohzapqwsowcq", "ronlmgbcktgxqnnkpchuglppmdeo", "xgztipllvrrvmgkxfwlwnrvxofvr", "maqgfcwuxctpymkmeuvqqudggmbp", "njzzpaiftcdxtkxezccozciozxxc", "kmgsxvmbnjuyqslzjsyhshdoqabq", "vtijlvxgqypqkaikdupvlokbsmep", "ynyxtcbsdpcoqxbhctjcmwxqppgh", "puyqjvpjnefuunzcxnbqoqfrjbio", "wjsycydnzwhecknvfktryircrdoy", "sfzvaymqzyiebzurddkwdoxlsdoy", "urgkzywpvrtxgpqmhpkskilujdwg", "twqzkudgpoqnfxniqeaeiplscqpo", "nxzvmfxdlxdcxhzeamajpbqxkxkr", "tjixmyhtcvbwohihokolwgmiwisk", "xssoafvfzmhfihteqgwjendjqxhh", "xevquenzdbungdmrvqoyoqpkdgad", "mwpgxaujhpgacqdbblujiynvkudq", "sldfdowhqpsdqyeizehxjtcdfcsx", "thhpbewdqhdblxqikwvhqfqtqbhw", "otxrybopbqrskulpvwwtbupmgtek", "gajgflidielmtqvpcjgazyrloknq", "mztggnnmjkxyqbmisbzyatwzyevz", "taqkcaluiqqnhbfbrvsfeiplomyf", "govoypyfnssgvhtvwwxqywvpmstn", "jizflprvdfdxmwbzwxgbrntplgmy", "iwemrqqqbwyfhjlcnltcrnnalltv", "gdlzzbrflfqsocbndwxdlhbebhoo", "rpsdrszbwjjalbqormfjxndiotxi", "mtnlhkskfzarxhbkqxfihnkztkwa", "nwxqwpkrhprnggqfexosmqlvpyhl", "vbukrokykrnjfzcjclctketovlnh", "bkzkkainjhikgwrxasnnkyhycbar", "eogeyrcwumsdsetnwuwxuhitxkmm", "glflxfygbkwtqexgnpggfyubxxwf", "bsqynbyqqrmlghjyeagdfskxbnnj", "pzcnoicqzyxesiysdiqlsnukirpj", "qnhicehuglbtqdfpqkaurbjypvbm", "fmtivamoowvjpoprtwchqzlwpdui", "vbfxdqqliulcotuntrzqrhqczwdq", "cmawxtaqwexbiubqmtzdtavwxtbz", "rihkisughqkjbqjjbnffpdmojgzs", "ltdhpwucebqtbzkpwdjfunublzbz", "egqsufpfafvtnjkrzfdhxawepfgy", "huuhhwefldutkwobozkwuvdmuajb", "ulefoaqyltcbqegnogljnykpehun", "puinagvdgmswnayanmjwtabzerqc", "ntoglocpkwmswgcqbmspmnrkhimv", "tgmjxfexftxlrgzkoygoscmgqzjl", "uuyvwnizmhepfunsfbloohqlwhsb", "pdhiberbvtjktczjcngbtjghfyor", "iqzsbcnvlnwfjsflsnbcipypzayj", "fbujczkespfuejjlizdfqrgpznxo", "xsltckbltnbwfyioswwzzgrujvbw", "xrklcntrctrssgydpdtflizncgmx", "xrcjattdsunahzdirfhwcjqsmglr", "kukhuosolkdlulhbffmrgropelow", "wdhkeukuhjgbocdbvrcdimrjnnna", "lwifjjejgthvszhatrbphwlnpcxp", "xaqilcytwfxvrklafavwribuxpok", "vkepahpidbjnggocpujygsgbxywx", "mlnbqyrrpbvrrksxqzzurunayjpy", "pluqbmldlylhijrdjyrryarmzmut", "fmjvhfsddavlbmhbwzfhcidnkaum", "qrkwsxpaaaciwqapgudhyahnvytw", "lsxsxjfdpqgcruemvoebhfzoqnyr", "toyjqdgwmiduhkboutrbkfvtvjrb", "qfpmgtcgfepwfpsbakcubcjrfqmu", "xqivfwcazypsrzwvmzxxxvtrvjus", "wdfwamwluvqotqfnbyttyifvueik", "zyivonxyemafhqlmqifoduyjepke", "kfawonwlqprvmdyiyroyhephrzij", "gqrtxlslpdqbvncylcridedtqttt", "iuecuzqbckkcexxtxbnmwjutcrsq", "yylaycjqoqrzthqykforhejadjco", "apmmevthqavywxrfxaopvzhjjkvd", "orkenhtxtwadpdgoiwvkpgvtirtf", "odealptqrmvquzxvgcwjpcxljssj", "jjbnejmiqtxklaesjybgvvjlsgzg", "kbnkwglcyfzyjbldwvvqbgcknpyl", "lnhxeycqrqlcpsalvllayrcrgsak", "ascasqavefcdpmcfzehxxzmnfhey", "sxyxtsisnczskbwjvmysztzleuhn", "bcufavqsadiclmukdzlxinghyzhj", "afbfdjhyoildfkvcuwqycxhuzwnc", "pfcdzbvjzlmznszzourpvtxjimug", "gjljkgbszlwwjfjpuhiwgujxujfn", "lfjwtqqbcrvdbvogxfyfyytlpvsp", "trfszxmcgenokzllkvflnuhjizsb", "bnbynbcuuppioeeduvpcflisswoa", "xvsvoaonzxfkghpkrzojenvqepbj", "ltttbvadajmenxddbztlgfrlaign", "qkimexeilczpivdssrzsultesbqz", "ndysmhiwlyaqkwmckftwjewajrro", "mgcbjuzcthymlwjbenjadedtgpsd", "ingufyxxclvqmqwifkozsxgqfddt", "udegpbgdywsydsriddmovmmvmcvk", "vseepxuvxspmhlvjhczovrnrnubb", "lxnjaifqmzcjnnrmdswdhvsltnwn", "ztiusmkcdswvnzhruxwmyuswxazy", "baptpieeypukfakdkkoqodwrygiw", "rggwlxvwbypnpjtjvhhbutzsskfp", "gcrimdebukwcxgasgxwxikmbquer", "pvndlgygivhbpghoplcactiympto", "dufvjhowfuvbdlipaixnesnqcggb", "qbcqobvkfbjkxpuealsldpwozeip", "fkktxsfqyxcniwliqozgbmiuurnx", "exhooppbipvvefulfjtjucrpluik", "kksrdgagangjydezgvzrlplgvyjh", "obgzxiijfeovrgomzvmiixasfamb", "smumapxtbhbmnotzymvuxaregxph", "vpgmqgljlrivspzxdjboatqrewel", "tlcsenuxuzspsghuynznlzeixazj", "fvruozisnuswdbekgaiqdlelqxug", "svxuhppdlxagawkixrskdfrwqhju", "tpamxbxdcgsicoojwzibanrzcszf", "qsxvggahkjhdyeulxaidpikvwwgn", "ntijrffpoxlafabgdupfohxbbvnf", "ndxoodoejgbuvehkqljjjrbicisd", "bxndkgmnrevhjzdicnzfdklpzgbb", "dwucpseneotbokgtqhqvwgxysxix", "obftzlzcdyzgfzuhweodalgtciut", "obqojzcrwuuctrgrqjttcukepegd", "ngdlqhhzlapjxtrjitlklpopehlp", "dwkcknqisufxscahupldehblrxxe", "hrjvzgrdqfejcueqiwruknlqbiuu", "gydvgfddjynfhdusfmrsajghxxiv", "pdfleiazjsidqzuwkomjtxjczsly", "grvwtenrixdouvnyocahvodhvdcy", "albpcahtnddtaqathkxpngwgmsaq", "xfdlyihstfiiueyyodnautnqilhl", "ykbbgalcoajgzaeatakusrlsxggo", "klcjzciwpkkhqfprkmmhdgujdgzl", "osccosfdgkxyxmshpbxsszakvgjb", "aukyetrjrfklmvpgxnqljqjrzdre", "fytxsnklukytalkpnhceqjotdyse", "vinvrkuuvjyrjgsqzarrvfdgmlfp", "blanxebljpofmtfwxyesoakzznku", "falhnkkczrvwzxpfkjwsvekdqswr", "slnprztihvuvhtslezqtmdvjvzbl", "rjzvbzxxnwepnxwjlgsqtwbujekd", "txlrhzrtkufsjhhxfgpzcdghkdke", "cejprerdoywwadebptcwfympprde", "qwrpdcqwlwrifezepapbwxaogaye"]	[50]	TODO
"pxdlvudqqfdhvyjmbppoalmeoqzsyqldqmmaazvwuylnlzeybajsgxefdjqwyiiwdfewunbeoymusodkbtkbelmkqbfwhrbypjpiwlfeekaesrlzhoaupclbeequvpfnvbaldlxcamjavcswxtxnlbkxvegltflpunwqlluuhwfwyobabcidtxaegavawcohkidosfqhyxlliynssaytmkyismcjjsrymujpziuhtjbqpkqphvapqldfsxirsxppsvazeyfouuxtjoarmrwrfmmomdgpammapfvtvybxqcmtnzhealhlxpueqetvyfmdnprwdyjsxsthqppjhgcvezskjtcujrcljazmkymzydfhqkkdkmillidcqxktzmnyfczpxlrtpmubjledhotbkkmeqvdpnoqcnpkhxymuztwosxwhinkxzjepbcmrnjmsvhhlmgwvizmifspjnrlkqvrposwyrgyqhmaetugfrmjptxxmkkheccyhcmimmzjelgyxeydwzesjuxglqhxnftxnfetljgxqptftksueunnmhnsfxhqyedorkroojixhcyemytodmybeokzicprlqpomjlccgqfkhzjtjergcaexsjtcvhidnrzwdeoqkwpcoxlpgopbjtkjgwohjriwyhzwnsabwfeeysioodumlbsldoztghnylberbdodvczefhzhirusanrwyandmnlsrvlaaurmbadutgsqluqngtjdkvwjhzjcdfwjccsexyapyabpyepddxhnllwzizelnnqzkqwqhuzidaowdfmwdpwtwbvpmnxisfwcxzuvrluundvfxuayeecnwymsaumyquxfkniajadlwierodnczzqdnlyyjkbabbwargbddupioaxljnaokhjzzpxyrkrotqbhqaisydijrmfftjhwkbfelycfnthtrqetvqithqsblqexanwhktuokrhzhlvkanwmfpdorduohmoeieuxdeanhtclgfoodecxyxynydyibrqhhcwileazdxydyrjwxojtyuilfznmyfgishkjuhaqvbheolniulcowjpadefwzzgzqkozzrgfoskwlzuvozaedfqwbszizbwgyibhxloyrspfktoshleiekpjkbneyvibuhzgksdyskvkwmklhlsudphnlxtuvcjsfyupifqmpywnzorcmlbzwckkqhlaofixjonnwqinhpsqfkuroltmaxjjjfethfplwerbknkcucgktuizvzwpccsigecnbrrdvdpddwgcogmzectnunebkeskiqzseayslcfmacrlcholfzrzkxmmgphozqawwlwzaalbwfyaorpwavyxlqevkumtbcuqahgzewmgtcokmffqawfuybhnlptybywxihzqblqxtvqqasgbwcrpezpvbotyruysnhqkzskhjedpedlxndgpgmglcauiofidalgxbrvqwtzsroxbvnjxevklplncetsqggqbramfcvfmmoxuybszckikyaeckupkuzawvqtdajrcpzbqibgjtodkbcttbowjxmcwbvanzszlzimwhakebnvykgztoduyzzmmoftnovrnusjxayexdstngvifiajwsnuafiohpghegreapyiqizcyovjkezdecfqgjvnxsvesqiibbqpsgriqcuubkcvmgaaweijuehnrmaywhqlsmsdruzobumxmfigzqjrrbjywplkstaxoyogoxopukutgatrvsyqzehoiksmhaetrkauqltcaiwakngdgfszzhnwcnuoaibsvxudrinszwyejycjjcdddomnoaolbulfnwvbpvrrrnhdodienlcfejfqehijxnmhvpkxnibbacpbndvgpdqimxwojupbpykxqihfzkevpiceboevjkunzxyogqgpvrnoxsvccsdkixwxyxwpkveewqkvgkxxynaaxmwdpmuoevyqwpbonjkvambyvbtekzdzlisxduykhlubwrpvfjbwnophndnbsfmjjmbttgwulhjzcxogluvrdncfozeduatwcvnlxhvklreabzdoktppmbcbirpdgamzmiyupmbhvvefochswnpurlrxfjafpzuihdasbnhfwustrvtfhyqcgtdcgwgpypdmzjmmwprzervwzuydohxfpdsmmsozpjwlcghapkstajpvwdytitldklkvrsfvjtzitqbapbkofriyezkohywcgffjohkpptfarervjiminczpeicnzakzlgdehuigijdxhujronxdzzqwwnvdodgeddaofkojyjjmhzxtkhkmqesitjlbijjbtpujrfqumtaujmyougkctkhddbplfhorgqdwxsvmmttnfkdzkumvlgaeldvmyivyvamltphfaecljxadufajckstuhfomirnkslxgbyahxnrxyusvoryglbuzuqldtlueqsemodgiqrewjebmvgikloewvxigramtyadrwdnipepxiweevflcwxorxrrznvwatignbnawmojfisbeffltymhavbhwclelsejbtgcoqyhwokxwgkpdjslrbzfmyrhyhlguwkcigoposnegrtfqieehjrgeynfmjcyctvhtiszagjaruleaxotlgyvdoybpsskevcymqsfqrwtlkduqjaavkptgchpfhjzwahgvwcocazihsafwblkahxaovowjtdkzykompwlqygyyovpgkwoqrrxzplaamxxcqirrgfedfcjxfxngryqdndspmifdtoxjrrdwpkmbtncbxqbbwtuhrugxacazstybhwqgdblrltarjnabmdzxqzwvepdpalwtqiassgrbasaugrjmuamcxsfggvpochzumspesjjaweywwegvdmfoehdejzkyceorecweobftjvncnudfixvfjabqvtwdfipzvslizefagdhnqocwiytpkvbqucnzvepbuhnludupvseoabekgdrkadmyxehwyuqoxfunheejeipqxauxjvkgtvfmgosyddrdsvfwgzcehrkjgljvcyvwtygtlgcmcibfeuterwizcxocbpdtdtprzphytfzlwtexydugmobjaninpbmzxiicfmxbbqddjkounduthjsejipvsyfxrrfmhdhzhigkvorwhwulznxoanitorpgfkmoggnsynzeyanmegsjuvmyhdkimlikacgoknysssuyaekdtciafdravacnuhbdobwgrmsrppnotbvdmujkqcsohqdxdgovltvfowpchusulwcsxokfhcwluirfypigymfjscohranfuqfnvgqjkacjcimsocsjrqzruxcwtqtyglohlhrdetelfobhhrkktiiiejedadjyepixsxaepqsbhbzlomdzqbxkqggjdvukxacsahefoeutwlnthowdpjnzvuoahcxhhdheinkkelhndhmyaglojwnzxoshhvlwazsckktwoevhngiapulsxlzwuqbnayjzsjmbdfqhzylbdgxqukdsanjdfffvhaowgkqcgnorauaruittvbetrsrpdenidopqgknebywnfelkoxwikxfisefyydzwvlisoiunbxgpglrolfkadebyyelbcydfulodsqqkoqjftdwxxfiazhlsndzkvgghjfyjnwdyoejbkkczgvsrlbkjpiyxidvuxixhpoifknumbbvrqjyionuctdczhdrhbzljsuicgdjrgzdzawhljsyudvkyaimsxnjvgudpfevzltpuuuwxnpgonkjixsihnurneeuzanpuiamyysaapalesfqvflwdwfoxrccsqbulxtpaiozdlybbjpzahyrbvekqltqmvkswxuueqrktntvwofeijvskgbelvbhlthzpnraqynjoibtbposvmhqmzbhoywecbrllynmlgneakoxrlxksjemdjpjuhnrzlfiuqqvcfnwuyjwpbogfcmvyirqmbtwybufpcaruyfpbiswhywdxgtaihjqzgixbadvxjqgugmjipctdokoowrrjqeacditjjglqkwbksoxunpcyrxlzzoopklkuuvwwxkyqoseyduooehrxvfcfvhzdbtfrpafgshzdwllmjecsuaxnlqdkdsuuizlyhiyhpxihrgeqtlqandiwhloajfynupanylhqrpoytzhdiyjyluprwcgcgdzpqxuxkxoypwlayzjkxcxrzuydzyxkwcrafliplrfhqetwlsfkfdipfrqpudrhndtdmfcsmswbencvsgqffvcsqgpcqvfftbsqefdyftgzicqibsluvtuoamxjudaaetjiltbeqrjjituhijneuecyoqmdhcjnlzydwskyryegbtssgsuuezqqglsxtlsxiiopasfsybgsvnshxgnpzfzrezzdiqakvljpbipuxenlmgbugbtbevaoovjbduaajgoqaccmbzswzkxbamadnzjoqcusbytfdznjeqnhegbjkbdswryhamtvjijobshpzhsldxzcxiazsjzvqxrjeskhiyasoegnnsjdsonxbyzbupccuiammsgdyayjcfjqfqsohsozixmynwxugiatmyrkrpymcujsbrdqrvgglidjpahezmdwzuottlqlvtjfstxbgnbwygcdodkxznwpeeoyxxejphmeemvttcnckzgsskszkllwxmpxutbiehoigifijqvyuvyucilmgdsgbgxwykgffflzrthdlrwjkpwmfqycnicrydfbnfpchhukuxnvbvzasfffnjsguzldgepprikkpltiriuaplrptpciscauuucpibmxsvkucwomgqcmmmifojloauddpgqyllybcxrgrpmjklsvsmaagubopujieyzvghfbjtbqaxihriwkqexzmkxyljzvembtepvsaqfzfjcpnarcdbpbingswbwxwqtnzgsxzfznmeetdxlhcwzvhzhbmbbgmvpjxglqfickorhvzzjeoanaxvneckirqyqqytgvccdxiywhhzgaxuzvhbgfaiphzryhsyjfxedmctgdvgjludkngbdahkecyffivtrjdmxsonyipesecbtkirxmiprzbewfyzilltbetgfaifqjuroooyzrqaipdpbllhcqptraipbzzparwlutprhksmrooaeuilbysariqawpoejthhqgcokzkoxglpmsvwivenukivjlgkxhfdnuvzkqxzcblrbkfxdbhfityuxobwamiitexhbhqtzmhtwominpwaapfmcuuxtotqcpytuwqkuywxjgewexmdpkrrbwbsthdlgjnukfjlvckbzvfjlkehihbslihsmaltplyjtuqerejasigjxtrepapwzsllafnftytqfjkpsfoxrflkrowjjhkoxdumxelmcnbslyebjzkqgourvhqzwexrkgsqebllkojojhuzqjgqmmtnpjkhxzbqkzuwijcxmyynmfcbmztolddwiglezyrtswpibktwncwenovtxgbrcucjeysrbrnrquxplesrlwhjmrnewrxoldpvlpkfjbparuofidpniswqrjbfccwtnsewgwahdfeeqkzjulwalzwfdqxxujpgwahhuelcbslecyszglvwiribetcmglawutjeoclufcmsvpzswqleegjoaocyewmmgxoffmqsrjxqxcdlntxtabzkuuxmsefgewczsuzkhfpwuzzgvfteevltxrfxwhnxrqcrkpaqkfybuhjxaspdwwkjfelanrtltwdhhjyzibmazxivsyiwpxkkganpsihtgyunuqcomjrjjnzryhcqwpmhfegfoxbotrdoexlyjfeqfrtvzladhciabalniyfcuvhavrrzmwgkfaqunwfxawmgusuoyqhodvbaqovbexyrmwwtbipggygeiuqzbdngtlajumqaewgabwzaglopgotyqrsppxmokcejrkphfpeuhjdnfjucpaxkgvjmvsbqfjttdouvfahdgoozpqeavushsrpjklyeckyxnfldlrhvgtfpwzokrafbubfbyvjhfejdkzhotjmtgkawijdxpxkecehssrwovkvqelxdfpkcjnyuwluhkbpevsuwkxtqzugwjsmiphjxvunkvgcflkbzkjdalkvylhpfhojgtcxpbsjqgynjgrokqjsidwzeljbzpdboncckqieqbmabxbiofirhgiuwnrdeugzpzulpoxbnmsbubscmimpaqeecwzlszigmowywwnwsnqnrqzvwjxutpavnvcnownbthsgbxhbsdrbsiclnchikeezsrcocknlcslexbvsgqbslejjbkpilthlhduonemqesrpkzgrgbljwfzqpbwwhrzweripwqbndopuxpjnvflrsaegnghxrdlwugss"	["zjtjergcaexsjtcvhidnrzwdeo", "ytfdznjeqnhegbjkbdswryhamt", "fulodsqqkoqjftdwxxfiazhlsn", "peeoyxxejphmeemvttcnckzgss", "lcowjpadefwzzgzqkozzrgfosk", "twlnthowdpjnzvuoahcxhhdhei", "trqetvqithqsblqexanwhktuok", "wdyjsxsthqppjhgcvezskjtcuj", "qaccmbzswzkxbamadnzjoqcusb", "vjijobshpzhsldxzcxiazsjzvq", "hzwnsabwfeeysioodumlbsldoz", "qtyglohlhrdetelfobhhrkktii", "nrwyandmnlsrvlaaurmbadutgs", "rlxksjemdjpjuhnrzlfiuqqvcf", "oehrxvfcfvhzdbtfrpafgshzdw", "xacazstybhwqgdblrltarjnabm", "ijuehnrmaywhqlsmsdruzobumx", "jkpsfoxrflkrowjjhkoxdumxel", "jloauddpgqyllybcxrgrpmjkls", "dmybeokzicprlqpomjlccgqfkh", "rbwbsthdlgjnukfjlvckbzvfjl", "jeipqxauxjvkgtvfmgosyddrds", "bvrqjyionuctdczhdrhbzljsui", "vfwgzcehrkjgljvcyvwtygtlgc", "rcljazmkymzydfhqkkdkmillid", "psskevcymqsfqrwtlkduqjaavk", "yapyabpyepddxhnllwzizelnnq", "parwlutprhksmrooaeuilbysar", "hqmzbhoywecbrllynmlgneakox", "zqqglsxtlsxiiopasfsybgsvns", "dhcjnlzydwskyryegbtssgsuue", "phozqawwlwzaalbwfyaorpwavy", "hxgnpzfzrezzdiqakvljpbipux", "cwluirfypigymfjscohranfuqf", "xrjeskhiyasoegnnsjdsonxbyz", "xtvqqasgbwcrpezpvbotyruysn", "twdfipzvslizefagdhnqocwiyt", "anaxvneckirqyqqytgvccdxiyw", "xlqevkumtbcuqahgzewmgtcokm", "xtuvcjsfyupifqmpywnzorcmlb", "pcaruyfpbiswhywdxgtaihjqzg", "xdgovltvfowpchusulwcsxokfh", "nwymsaumyquxfkniajadlwiero", "iunbxgpglrolfkadebyyelbcyd", "oxjrrdwpkmbtncbxqbbwtuhrug", "panylhqrpoytzhdiyjyluprwcg", "osnegrtfqieehjrgeynfmjcyct", "kpdjslrbzfmyrhyhlguwkcigop", "edmctgdvgjludkngbdahkecyff", "duyzzmmoftnovrnusjxayexdst", "hfzkevpiceboevjkunzxyogqgp", "xlzzoopklkuuvwwxkyqoseyduo", "tgwulhjzcxogluvrdncfozedua", "wblkahxaovowjtdkzykompwlqy", "cghapkstajpvwdytitldklkvrs", "xdeanhtclgfoodecxyxynydyib", "nxisfwcxzuvrluundvfxuayeec", "gffjohkpptfarervjiminczpei", "ittvbetrsrpdenidopqgknebyw", "anmegsjuvmyhdkimlikacgokny", "hqkzskhjedpedlxndgpgmglcau", "alesfqvflwdwfoxrccsqbulxtp", "uuucpibmxsvkucwomgqcmmmifo", "uoaibsvxudrinszwyejycjjcdd", "kswxuueqrktntvwofeijvskgbe", "ptgchpfhjzwahgvwcocazihsaf", "kfdipfrqpudrhndtdmfcsmswbe", "wivenukivjlgkxhfdnuvzkqxzc", "qluqngtjdkvwjhzjcdfwjccsex", "kehihbslihsmaltplyjtuqerej", "mfigzqjrrbjywplkstaxoyogox", "uybszckikyaeckupkuzawvqtda", "ffqawfuybhnlptybywxihzqblq", "qkwpcoxlpgopbjtkjgwohjriwy", "ienlcfejfqehijxnmhvpkxnibb", "iejedadjyepixsxaepqsbhbzlo", "nwuyjwpbogfcmvyirqmbtwybuf", "gsqebllkojojhuzqjgqmmtnpjk", "domnoaolbulfnwvbpvrrrnhdod", "ngvifiajwsnuafiohpghegreap", "tghnylberbdodvczefhzhirusa", "vrnoxsvccsdkixwxyxwpkveewq", "rewjebmvgikloewvxigramtyad", "seayslcfmacrlcholfzrzkxmmg", "aiozdlybbjpzahyrbvekqltqmv", "osxwhinkxzjepbcmrnjmsvhhlm", "lznxoanitorpgfkmoggnsynzey", "wlzuvozaedfqwbszizbwgyibhx", "jqeacditjjglqkwbksoxunpcyr", "bwgrmsrppnotbvdmujkqcsohqd", "rqhhcwileazdxydyrjwxojtyui", "blrbkfxdbhfityuxobwamiitex", "rwdnipepxiweevflcwxorxrrzn", "zzqwwnvdodgeddaofkojyjjmhz", "hbhqtzmhtwominpwaapfmcuuxt", "sozixmynwxugiatmyrkrpymcuj", "buhzgksdyskvkwmklhlsudphnl", "fvjtzitqbapbkofriyezkohywc", "rhzhlvkanwmfpdorduohmoeieu", "otbkkmeqvdpnoqcnpkhxymuztw", "asigjxtrepapwzsllafnftytqf", "ixbadvxjqgugmjipctdokoowrr", "nkkelhndhmyaglojwnzxoshhvl", "aisydijrmfftjhwkbfelycfnth", "dpddwgcogmzectnunebkeskiqz", "gyyovpgkwoqrrxzplaamxxcqir", "loyrspfktoshleiekpjkbneyvi", "dwxsvmmttnfkdzkumvlgaeldvm", "wbvanzszlzimwhakebnvykgzto", "ioaxljnaokhjzzpxyrkrotqbhq", "phytfzlwtexydugmobjaninpbm", "bmbbgmvpjxglqfickorhvzzjeo", "sqiibbqpsgriqcuubkcvmgaawe", "mdzqbxkqggjdvukxacsahefoeu", "nvgqjkacjcimsocsjrqzruxcwt", "wazsckktwoevhngiapulsxlzwu", "mtaujmyougkctkhddbplfhorgq", "dzxqzwvepdpalwtqiassgrbasa", "jjaweywwegvdmfoehdejzkyceo", "chhukuxnvbvzasfffnjsguzldg", "epprikkpltiriuaplrptpcisca", "bekgdrkadmyxehwyuqoxfunhee", "tjiltbeqrjjituhijneuecyoqm", "zwckkqhlaofixjonnwqinhpsqf", "pkvbqucnzvepbuhnludupvseoa", "kuroltmaxjjjfethfplwerbknk", "bupccuiammsgdyayjcfjqfqsoh", "njvgudpfevzltpuuuwxnpgonkj", "xtkhkmqesitjlbijjbtpujrfqu", "acpbndvgpdqimxwojupbpykxqi", "yftgzicqibsluvtuoamxjudaae", "avbhwclelsejbtgcoqyhwokxwg", "sbrdqrvgglidjpahezmdwzuott", "mimmzjelgyxeydwzesjuxglqhx", "otqcpytuwqkuywxjgewexmdpkr", "lfznmyfgishkjuhaqvbheolniu", "ddwiglezyrtswpibktwncwenov", "kvgkxxynaaxmwdpmuoevyqwpbo", "ubwrpvfjbwnophndnbsfmjjmbt", "purlrxfjafpzuihdasbnhfwust", "qbnayjzsjmbdfqhzylbdgxqukd", "cucgktuizvzwpccsigecnbrrdv", "njkvambyvbtekzdzlisxduykhl", "gwvizmifspjnrlkqvrposwyrgy", "saqfzfjcpnarcdbpbingswbwxw", "twcvnlxhvklreabzdoktppmbcb", "vwatignbnawmojfisbeffltymh", "iqawpoejthhqgcokzkoxglpmsv", "vklplncetsqggqbramfcvfmmox", "enlmgbugbtbevaoovjbduaajgo", "nsfxhqyedorkroojixhcyemyto", "cnzakzlgdehuigijdxhujronxd", "yivyvamltphfaecljxadufajck", "jrcpzbqibgjtodkbcttbowjxmc", "vhtiszagjaruleaxotlgyvdoyb", "recweobftjvncnudfixvfjabqv", "dzkvgghjfyjnwdyoejbkkczgvs", "rgfedfcjxfxngryqdndspmifdt", "cgdzpqxuxkxoypwlayzjkxcxrz", "hxzbqkzuwijcxmyynmfcbmztol", "lqlvtjfstxbgnbwygcdodkxznw", "thdlrwjkpwmfqycnicrydfbnfp", "cmtnzhealhlxpueqetvyfmdnpr", "yuvyucilmgdsgbgxwykgffflzr", "ncvsgqffvcsqgpcqvfftbsqefd", "ipvsyfxrrfmhdhzhigkvorwhwu", "qhmaetugfrmjptxxmkkheccyhc", "hhzgaxuzvhbgfaiphzryhsyjfx", "cqxktzmnyfczpxlrtpmubjledh", "mcibfeuterwizcxocbpdtdtprz", "irpdgamzmiyupmbhvvefochswn", "opukutgatrvsyqzehoiksmhaet", "rvtfhyqcgtdcgwgpypdmzjmmwp", "ixsihnurneeuzanpuiamyysaap", "hpxihrgeqtlqandiwhloajfynu", "uydzyxkwcrafliplrfhqetwlsf", "llmjecsuaxnlqdkdsuuizlyhiy", "vsmaagubopujieyzvghfbjtbqa", "zkqwqhuzidaowdfmwdpwtwbvpm", "voryglbuzuqldtlueqsemodgiq", "iofidalgxbrvqwtzsroxbvnjxe", "sssuyaekdtciafdravacnuhbdo", "dnczzqdnlyyjkbabbwargbddup", "sanjdfffvhaowgkqcgnorauaru", "ooyzrqaipdpbllhcqptraipbzz", "rkauqltcaiwakngdgfszzhnwcn", "yiqizcyovjkezdecfqgjvnxsve", "rlbkjpiyxidvuxixhpoifknumb", "nfelkoxwikxfisefyydzwvliso", "mcnbslyebjzkqgourvhqzwexrk", "cgdjrgzdzawhljsyudvkyaimsx", "nftxnfetljgxqptftksueunnmh", "qtnzgsxzfznmeetdxlhcwzvhzh", "rzervwzuydohxfpdsmmsozpjwl", "stuhfomirnkslxgbyahxnrxyus", "przbewfyzilltbetgfaifqjuro", "ivtrjdmxsonyipesecbtkirxmi", "xihriwkqexzmkxyljzvembtepv", "zxiicfmxbbqddjkounduthjsej", "kszkllwxmpxutbiehoigifijqv", "lvbhlthzpnraqynjoibtbposvm", "ugrjmuamcxsfggvpochzumspes"]	[297]	TODO
"iiiiiiiiiiiiiiiiiiiiiiiiiiiiiiiiiiiiiiiiiiiiiiiiiiiiiiiiiiiiiiiiiiiiiiiiiiiiiiiiiiiiiiiiiiiiiiiiiiiiiiiiiiiiiiiiiiiiiiiiiiiiiiiiiiiiiiiiiiiiiiiiiiiiiiiiiiiiiiiiiiiiiiiiiiiiiiiiiiiiiiiiiiiiiiiiiiiiiiiiiiiiiiiiiiiiiiiiiiiiiiiiiiiiiiiiiiiiiiiiiiiiiiiiiiiiiiiiiiiiiiiiiiiiiiiiiiiiiiiiiiiiiiiiiiiiiiiiiiiiiiiiiiiiiiiiiiiiiiiiiiiiiiiiiiiiiiiiiiiiiiiiiiiiiiiiiiiiiiiiiiiiiiiiiiiiiiiiiiiiiiiiiiiiiiiiiiiiiiiiiiiiiiiiiiiiiiiiiiiiiiiiiiiiiiiiiiiiiiiiiiiiiiiiiiiiiiiiiiiiiiiiiiiiiiiiiiiiiiiiiiiiiiiiiiiiiiiiiiiiiiiiiiiiiiiiiiiiiiiiiiiiiiiiiiiiiiiiiiiiiiiiiiiiiiiiiiiiiiiiiiiiiiiiiiiiiiiiiiiiiiiiiiiiiiiiiiiiiiiiiiiiiiiiiiiiiiiiiiiiiiiiiiiiiiiiiiiiiiiiiiiiiiiiiiiiiiiiiiiiiiiiiiiiiiiiiiiiiiiiiiiiiiiiiiiiiiiiiiiiiiiiiiiiiiiiiiiiiiiiiiiiiiiiiiiiiiiiiiiiiiiiiiiiiiiiiiiiiiiiiiiiiiiiiiiiiiiiiiiiiiiiiiiiiiiiiiiiiiiiiiiiiiiiiiiiiiiiiiiiiiiiiiiiiiiiiiiiiiiiiiiiiiiiiiiiiiiiiiiiiiiiiiiiiiiiiiiiiiiiiiiiiiiiiiiiiiiiiiiiiiiiiiiiiiiiiiiiiiiiiiiiiiiiiiiiiiiiiiiiiiiiiiiiiiiiiiiiiiiiiiiiiiiiiiiiiiiiiiiiiiiiiiiiiiiiiiiiiiiiiiiiiiiiiiiiiiiiiiiiiiiiiiiiiiiiiiiiiiiiiiiiiiiiiiiiiiiiiiiiiiiiiiiiiiiiiiiiiiiiiiiiiiiiiiiiiiiiiiiiiiiiiiiiiiiiiiiiiiiiiiiiiiiiiiiiiiiiiiiiiiiiiiiiiiiiiiiiiiiiiiiiiiiiiiiiiiiiiiiiiiiiiiiiiiiiiiiiiiiiiiiiiiiiiiiiiiiiiiiiiiiiiiiiiiiiiiiiiiiiiiiiiiiiiiiiiiiiiiiiiiiiiiiiiiiiiiiiiiiiiiiiiiiiiiiiiiiiiiiiiiiiiiiiiiiiiiiiiiiiiiiiiiiiiiiiiiiiiiiiiiiiiiiiiiiiiiiiiiiiiiiiiiiiiiiiiiiiiiiiiiiiiiiiiiiiiiiiiiiiiiiiiiiiiiiiiiiiiiiiiiiiiiiiiiiiiiiiiiiiiiiiiiiiiiiiiiiiiiiiiiiiiiiiiiiiiiiiiiiiiiiiiiiiiiiiiiiiiiiiiiiiiiiiiiiiiiiiiiiiiiiiiiiiiiiiiiiiiiiiiiiiiiiiiiiiiiiiiiiiiiiiiiiiiiiiiiiiiiiiiiiiiiiiiiiiiiiiiiiiiiiiiiiiiiiiiiiiiiiiiiiiiiiiiiiiiiiiiiiiiiiiiiiiiiiiiiiiiiiiiiiiiiiiiiiiiiiiiiiiiiiiiiiiiiiiiiiiiiiiiiiiiiiiiiiiiiiiiiiiiiiiiiiiiiiiiiiiiiiiiiiiiiiiiiiiiiiiiiiiiiiiiiiiiiiiiiiiiiiiiiiiiiiiiiiiiiiiiiiiiiiiiiiiiiiiiiiiiiiiiiiiiiiiiiiiiiiiiiiiiiiiiiiiiiiiiiiiiiiiiiiiiiiiiiiiiiiiiiiiiiiiiiiiiiiiiiiiiiiiiiiiiiiiiiiiiiiiiiiiiiiiiiiiiiiiiiiiiiiiiiiiiiiiiiiiiiiiiiiiiiiiiiiiiiiiiiiiiiiiiiiiiiiiiiiiiiiiiiiiiiiiiiiiiiiiiiiiiiiiiiiiiiiiiiiiiiiiiiiiiiiiiiiiiiiiiiiiiiiiiiiiiiiiiiiiiiiiiiiiiiiiiiiiiiiiiiiiiiiiiiiiiiiiiiiiiiiiiiiiiiiiiiiiiiiiiiiiiiiiiiiiiiiiiiiiiiiiiiiiiiiiiiiiiiiiiiiiiiiiiiiiiiiiiiiiiiiiiiiiiiiiiiiiiiiiiiiiiiiiiiiiiiiiiiiiiiiiiiiiiiiiiiiiiiiiiiiiiiiiiiiiiiiiiiiiiiiiiiiiiiiiiiiiiiiiiiiiiiiiiiiiiiiiiiiiiiiiiiiiiiiiiiiiiiiiiiiiiiiiiiiiiiiiiiiiiiiiiiiiiiiiiiiiiiiiiiiiiiiiiiiiiiiiiiiiiiiiiiiiiiiiiiiiiiiiiiiiiiiiiiiiiiiiiiiiiiiiiiiiiiiiiiiiiiiiiiiiiiiiiiiiiiiiiiiiiiiiiiiiiiiiiiiiiiiiiiiiiiiiiiiiiiiiiiiiiiiiiiiiiiiiiiiiiiiiiiiiiiiiiiiiiiiiiiiiiiiiiiiiiiiiiiiiiiiiiiiiiiiiiiiiiiiiiiiiiiiiiiiiiiiiiiiiiiiiiiiiiiiiiiiiiiiiiiiiiiiiiiiiiiiiiiiiiiiiiiiiiiiiiiiiiiiiiiiiiiiiiiiiiiiiiiiiiiiiiiiiiiiiiiiiiiiiiiiiiiiiiiiiiiiiiiiiiiiiiiiiiiiiiiiiiiiiiiiiiiiiiiiiiiiiiiiiiiiiiiiiiiiiiiiiiiiiiiiiiiiiiiiiiiiiiiiiiiiiiiiiiiiiiiiiiiiiiiiiiiiiiiiiiiiiiiiiiiiiiiiiiiiiiiiiiiiiiiiiiiiiiiiiiiiiiiiiiiiiiiiiiiiiiiiiiiiiiiiiiiiiiiiiiiiiiiiiiiiiiiiiiiiiiiiiiiiiiiiiiiiiiiiiiiiiiiiiiiiiiiiiiiiiiiiiiiiiiiiiiiiiiiiiiiiiiiiiiiiiiiiiiiiiiiiiiiiiiiiiiiiiiiiiiiiiiiiiiiiiiiiiiiiiiiiiiiiiiiiiiiiiiiiiiiiiiiiiiiiiiiiiiiiiiiiiiiiiiiiiiiiiiiiiiiiiiiiiiiiiiiiiiiiiiiiiiiiiiiiiiiiiiiiiiiiiiiiiiiiiiiiiiiiiiiiiiiiiiiiiiiiiiiiiiiiiiiiiiiiiiiiiiiiiiiiiiiiiiiiiiiiiiiiiiiiiiiiiiiiiiiiiiiiiiiiiiiiiiiiiiiiiiiiiiiiiiiiiiiiiiiiiiiiiiiiiiiiiiiiiiiiiiiiiiiiiiiiiiiiiiiiiiiiiiiiiiiiiiiiiiiiiiiiiiiiiiiiiiiiiiiiiiiiiiiiiiiiiiiiiiiiiiiiiiiiiiiiiiiiiiiiiiiiiiiiiiiiiiiiiiiiiiiiiiiiiiiiiiiiiiiiiiiiiiiiiiiiiiiiiiiiiiiiiiiiiiiiiiiiiiiiiiiiiiiiiiiiiiiiiiiiiiiiiiiiiiiiiiiiiiiiiiiiiiiiiiiiiiiiiiiiiiiiiiiiiiiiiiiiiiiiiiiiiiiiiiiiiiiiiiiiiiiiiiiiiiiiiiiiiiiiiiiiiiiiiiiiiiiiiiiiiiiiiiiiiiiiiiiiiiiiiiiiiiiiiiiiiiiiiiiiiiiiiiiiiiiiiiiiiiiiiiiiiiiiiiiiiiiiiiiiiiiiiiiiiiiiiiiiiiiiiiiiiiiiiiiiiiiiiiiiiiiiiiiiiiiiiiiiiiiiiiiiiiiiiiiiiiiiiiiiiiiiiiiiiiiiiiiiiiiiiiiiiiiiiiiiiiiiiiiiiiiiiiiiiiiiiiiiiiiiiiiiiiiiiiiiiiiiiiiiiiiiiiiiiiiiiiiiiiiiiiiiiiiiiiiiiiiiiiiiiiiiiiiiiiiiiiiiiiiiiiiiiiiiiiiiiiiiiiiiiiiiiiiiiiiiiiiiiiiiiiiiiiiiiiiiiiiiiiiiiiiiiiiiiiiiiiiiiiiiiiiiiiiiiiiiiiiiiiiiiiiiiiiiiiiiiiiiiiiiiiiiiiiiiiiiiiiiiiiiiiiiiiiiiiiiiiiiiiiiiiiiiiiiiiiiiiiiiiiiiiiiiiiiiiiiiiiiiiiiiiiiiiiiiiiiiiiiiiiiiiiiiiiiiiiiiiiiiiiiiiiiiiiiiiiiiiiiiiiiiiiiiiiiiiiiiiiiiiiiiiiiiiiiiiiiiiiiiiiiiiiiiiiiiiiiiiiiiiiiiiiiiiiiiiiiiiiiiiiiiiiiiiiiiiiiiiiiiiiiiiiiiiiiiiiiiiiiiiiiiiiiiiiiiiiiiiiiiiiiiiiiiiiiiiiiiiiiiiiiiiiiiiiiiiiiiiiiiiiiiiiiiiiiiiiiiiiiiiiiiiiiiiiiiiiiiiiiiiiiiiiiiiiiiiiiiiiiiiiiiiiiiiiiiiiiiiiiiiiiiiiiiiiiiiiiiiiiiiiiiiiiiiiiiiiiiiiiiiiiiiiiiiiiiiiiiiiiiiiiiiiiiiiiiiiiiiiiiiiiiiiiiiiiiiiiiiiiiiiiiiiiiiiiiiiiiiiiiiiiiiiiiiiiiiiiiiiiiiiiiiiiiiiiiiiiiiiiiiiiiiiiiiiiiiiiiiiiiiiiiiiiiiiiiiiiiiiiiiiiiiiiiiiiiiiiiiiiiiiiiiiiiiiiiiiiiiiiiiiiiiiiiiiiiiiiiiiiiiiiiiiiiiiiiiiiiiiiiiiiiiiiiiiiiiiiiiiiiiiiiiiiiiiiiiiiiiiiiiiiiiiiiiiiiiiiiiiiiiiiiiiiiiiiiiiiiiiiiiiiiiiiiiiiiiiiiiiiiiiiiiiiiiiiiiiiiiiiiiiiiiiiiiiiiiiiiiiiiiiiiiiiiiiiiiiiiiiiiiiiiiiiiiiiiiiiiiiiiiiiiiiiiiiiiiiiiiiiiiiiiiiiiiiiiiiiiiiiiiiiiiiiiiiiiiiiiiiiiiiiiiiiiiiiiiiiiiiiiiiiiiiii"	["i", "i", "i", "i", "i", "i", "i", "i", "i", "i", "i", "i", "i", "i", "i", "i", "i", "i", "i", "i", "i", "i", "i", "i", "i", "i", "i", "i", "i", "i", "i", "i", "i", "i", "i", "i", "i", "i", "i", "i", "i", "i", "i", "i", "i", "i", "i", "i", "i", "i", "i", "i", "i", "i", "i", "i", "i", "i", "i", "i", "i", "i", "i", "i", "i", "i", "i", "i", "i", "i", "i", "i", "i", "i", "i", "i", "i", "i", "i", "i", "i", "i", "i", "i", "i", "i", "i", "i", "i", "i", "i", "i", "i", "i", "i", "i", "i", "i", "i", "i", "i", "i", "i", "i", "i", "i", "i", "i", "i", "i", "i", "i", "i", "i", "i", "i", "i", "i", "i", "i", "i", "i", "i", "i", "i", "i", "i", "i", "i", "i", "i", "i", "i", "i", "i", "i", "i", "i", "i", "i", "i", "i", "i", "i", "i", "i", "i", "i", "i", "i", "i", "i", "i", "i", "i", "i", "i", "i", "i", "i", "i", "i", "i", "i", "i", "i", "i", "i", "i", "i", "i", "i", "i", "i", "i", "i", "i", "i", "i", "i", "i", "i", "i", "i", "i", "i", "i", "i", "i", "i", "i", "i", "i", "i", "i", "i", "i", "i", "i", "i", "i", "i", "i", "i", "i", "i", "i", "i", "i", "i", "i", "i", "i", "i", "i", "i", "i", "i", "i", "i", "i", "i", "i", "i", "i", "i", "i", "i", "i", "i", "i", "i", "i", "i", "i", "i", "i", "i", "i", "i", "i", "i", "i", "i", "i", "i", "i", "i", "i", "i", "i", "i", "i", "i", "i", "i", "i", "i", "i", "i", "i", "i", "i", "i", "i", "i", "i", "i", "i", "i", "i", "i", "i", "i", "i", "i", "i", "i", "i", "i", "i", "i", "i", "i", "i", "i", "i", "i", "i", "i", "i", "i", "i", "i", "i", "i", "i", "i", "i", "i", "i", "i", "i", "i", "i", "i", "i", "i", "i", "i", "i", "i", "i", "i", "i", "i", "i", "i", "i", "i", "i", "i", "i", "i", "i", "i", "i", "i", "i", "i", "i", "i", "i", "i", "i", "i", "i", "i", "i", "i", "i", "i", "i", "i", "i", "i", "i", "i", "i", "i", "i", "i", "i", "i", "i", "i", "i", "i", "i", "i", "i", "i", "i", "i", "i", "i", "i", "i", "i", "i", "i", "i", "i", "i", "i", "i", "i", "i", "i", "i", "i", "i", "i", "i", "i", "i", "i", "i", "i", "i", "i", "i", "i", "i", "i", "i", "i", "i", "i", "i", "i", "i", "i", "i", "i", "i", "i", "i", "i", "i", "i", "i", "i", "i", "i", "i", "i", "i", "i", "i", "i", "i", "i", "i", "i", "i", "i", "i", "i", "i", "i", "i", "i", "i", "i", "i", "i", "i", "i", "i", "i", "i", "i", "i", "i", "i", "i", "i", "i", "i", "i", "i", "i", "i", "i", "i", "i", "i", "i", "i", "i", "i", "i", "i", "i", "i", "i", "i", "i", "i", "i", "i", "i", "i", "i", "i", "i", "i", "i", "i", "i", "i", "i", "i", "i", "i", "i", "i", "i", "i", "i", "i", "i", "i", "i", "i", "i", "i", "i", "i", "i", "i", "i", "i", "i", "i", "i", "i", "i", "i", "i", "i", "i", "i", "i", "i", "i", "i", "i", "i", "i", "i", "i", "i", "i", "i", "i", "i", "i", "i", "i", "i", "i", "i", "i", "i", "i", "i", "i", "i", "i", "i", "i", "i", "i", "i", "i", "i", "i", "i", "i", "i", "i", "i", "i", "i", "i", "i", "i", "i", "i", "i", "i", "i", "i", "i", "i", "i", "i", "i", "i", "i", "i", "i", "i", "i", "i", "i", "i", "i", "i", "i", "i", "i", "i", "i", "i", "i", "i", "i", "i", "i", "i", "i", "i", "i", "i", "i", "i", "i", "i", "i", "i", "i", "i", "i", "i", "i", "i", "i", "i", "i", "i", "i", "i", "i", "i", "i", "i", "i", "i", "i", "i", "i", "i", "i", "i", "i", "i", "i", "i", "i", "i", "i", "i", "i", "i", "i", "i", "i", "i", "i", "i", "i", "i", "i", "i", "i", "i", "i", "i", "i", "i", "i", "i", "i", "i", "i", "i", "i", "i", "i", "i", "i", "i", "i", "i", "i", "i", "i", "i", "i", "i", "i", "i", "i", "i", "i", "i", "i", "i", "i", "i", "i", "i", "i", "i", "i", "i", "i", "i", "i", "i", "i", "i", "i", "i", "i", "i", "i", "i", "i", "i", "i", "i", "i", "i", "i", "i", "i", "i", "i", "i", "i", "i", "i", "i", "i", "i", "i", "i", "i", "i", "i", "i", "i", "i", "i", "i", "i", "i", "i", "i", "i", "i", "i", "i", "i", "i", "i", "i", "i", "i", "i", "i", "i", "i", "i", "i", "i", "i", "i", "i", "i", "i", "i", "i", "i", "i", "i", "i", "i", "i", "i", "i", "i", "i", "i", "i", "i", "i", "i", "i", "i", "i", "i", "i", "i", "i", "i", "i", "i", "i", "i", "i", "i", "i", "i", "i", "i", "i", "i", "i", "i", "i", "i", "i", "i", "i", "i", "i", "i", "i", "i", "i", "i", "i", "i", "i", "i", "i", "i", "i", "i", "i", "i", "i", "i", "i", "i", "i", "i", "i", "i", "i", "i", "i", "i", "i", "i", "i", "i", "i", "i", "i", "i", "i", "i", "i", "i", "i", "i", "i", "i", "i", "i", "i", "i", "i", "i", "i", "i", "i", "i", "i", "i", "i", "i", "i", "i", "i", "i", "i", "i", "i", "i", "i", "i", "i", "i", "i", "i", "i", "i", "i", "i", "i", "i", "i", "i", "i", "i", "i", "i", "i", "i", "i", "i", "i", "i", "i", "i", "i", "i", "i", "i", "i", "i", "i", "i", "i", "i", "i", "i", "i", "i", "i", "i", "i", "i", "i", "i", "i", "i", "i", "i", "i", "i", "i", "i", "i", "i", "i", "i", "i", "i", "i", "i", "i", "i", "i", "i", "i", "i", "i", "i", "i", "i", "i", "i", "i", "i", "i", "i", "i", "i", "i", "i", "i", "i", "i", "i", "i", "i", "i", "i", "i", "i", "i", "i", "i", "i", "i", "i", "i", "i", "i", "i", "i", "i", "i", "i", "i", "i", "i", "i", "i", "i", "i", "i", "i", "i", "i", "i", "i", "i", "i", "i", "i", "i", "i", "i", "i", "i", "i", "i", "i", "i", "i", "i", "i", "i", "i", "i", "i", "i", "i", "i", "i", "i", "i", "i", "i", "i", "i", "i", "i", "i", "i", "i", "i", "i", "i", "i", "i", "i", "i", "i", "i", "i", "i", "i", "i", "i", "i", "i", "i", "i", "i", "i", "i", "i", "i", "i", "i", "i", "i", "i", "i", "i", "i", "i", "i", "i", "i", "i", "i", "i", "i", "i", "i", "i", "i", "i", "i", "i", "i", "i", "i", "i", "i", "i", "i", "i", "i", "i", "i", "i", "i", "i", "i", "i", "i", "i", "i", "i", "i", "i", "i", "i", "i", "i", "i", "i", "i", "i", "i", "i", "i", "i", "i", "i", "i", "i", "i", "i", "i", "i", "i", "i", "i", "i", "i", "i", "i", "i", "i", "i", "i", "i", "i", "i", "i", "i", "i", "i", "i", "i", "i", "i", "i", "i", "i", "i", "i", "i", "i", "i", "i", "i", "i", "i", "i", "i", "i", "i", "i", "i", "i", "i", "i", "i", "i", "i", "i", "i", "i", "i", "i", "i", "i", "i", "i", "i", "i", "i", "i", "i", "i", "i", "i", "i", "i", "i", "i", "i", "i", "i", "i", "i", "i", "i", "i", "i", "i", "i", "i", "i", "i", "i", "i", "i", "i", "i", "i", "i", "i", "i", "i", "i", "i", "i", "i", "i", "i", "i", "i", "i", "i", "i", "i", "i", "i", "i", "i", "i", "i", "i", "i", "i", "i", "i", "i", "i", "i", "i", "i", "i", "i", "i", "i", "i", "i", "i", "i", "i", "i", "i", "i", "i", "i", "i", "i", "i", "i", "i", "i", "i", "i", "i", "i", "i", "i", "i", "i", "i", "i", "i", "i", "i", "i", "i", "i", "i", "i", "i", "i", "i", "i", "i", "i", "i", "i", "i", "i", "i", "i", "i", "i", "i", "i", "i", "i", "i", "i", "i", "i", "i", "i", "i", "i", "i", "i", "i", "i", "i", "i", "i", "i", "i", "i", "i", "i", "i", "i", "i", "i", "i", "i", "i", "i", "i", "i", "i", "i", "i", "i", "i", "i", "i", "i", "i", "i", "i", "i", "i", "i", "i", "i", "i", "i", "i", "i", "i", "i", "i", "i", "i", "i", "i", "i", "i", "i", "i", "i", "i", "i", "i", "i", "i", "i", "i", "i", "i", "i", "i", "i", "i", "i", "i", "i", "i", "i", "i", "i", "i", "i", "i", "i", "i", "i", "i", "i", "i", "i", "i", "i", "i", "i", "i", "i", "i", "i", "i", "i", "i", "i", "i", "i", "i", "i", "i", "i", "i", "i", "i", "i", "i", "i", "i", "i", "i", "i", "i", "i", "i", "i", "i", "i", "i", "i", "i", "i", "i", "i", "i", "i", "i", "i", "i", "i", "i", "i", "i", "i", "i", "i", "i", "i", "i", "i", "i", "i", "i", "i", "i", "i", "i", "i", "i", "i", "i", "i", "i", "i", "i", "i", "i", "i", "i", "i", "i", "i", "i", "i", "i", "i", "i", "i", "i", "i", "i", "i", "i", "i", "i", "i", "i", "i", "i", "i", "i", "i", "i", "i", "i", "i", "i", "i", "i", "i", "i", "i", "i", "i", "i", "i", "i", "i", "i", "i", "i", "i", "i", "i", "i", "i", "i", "i", "i", "i", "i", "i", "i", "i", "i", "i", "i", "i", "i", "i", "i", "i", "i", "i", "i", "i", "i", "i", "i", "i", "i", "i", "i", "i", "i", "i", "i", "i", "i", "i", "i", "i", "i", "i", "i", "i", "i", "i", "i", "i", "i", "i", "i", "i", "i", "i", "i", "i", "i", "i", "i", "i", "i", "i", "i", "i", "i", "i", "i", "i", "i", "i", "i", "i", "i", "i", "i", "i", "i", "i", "i", "i", "i", "i", "i", "i", "i", "i", "i", "i", "i", "i", "i", "i", "i", "i", "i", "i", "i", "i", "i", "i", "i", "i", "i", "i", "i", "i", "i", "i", "i", "i", "i", "i", "i", "i", "i", "i", "i", "i", "i", "i", "i", "i", "i", "i", "i", "i", "i", "i", "i", "i", "i", "i", "i", "i", "i", "i", "i", "i", "i", "i", "i", "i", "i", "i", "i", "i", "i", "i", "i", "i", "i", "i", "i", "i", "i", "i", "i", "i", "i", "i", "i", "i", "i", "i", "i", "i", "i", "i", "i", "i", "i", "i", "i", "i", "i", "i", "i", "i", "i", "i", "i", "i", "i", "i", "i", "i", "i", "i", "i", "i", "i", "i", "i", "i", "i", "i", "i", "i", "i", "i", "i", "i", "i", "i", "i", "i", "i", "i", "i", "i", "i", "i", "i", "i", "i", "i", "i", "i", "i", "i", "i", "i", "i", "i", "i", "i", "i", "i", "i", "i", "i", "i", "i", "i", "i", "i", "i", "i", "i", "i", "i", "i", "i", "i", "i", "i", "i", "i", "i", "i", "i", "i", "i", "i", "i", "i", "i", "i", "i", "i", "i", "i", "i", "i", "i", "i", "i", "i", "i", "i", "i", "i", "i", "i", "i", "i", "i", "i", "i", "i", "i", "i", "i", "i", "i", "i", "i", "i", "i", "i", "i", "i", "i", "i", "i", "i", "i", "i", "i", "i", "i", "i", "i", "i", "i", "i", "i", "i", "i", "i", "i", "i", "i", "i", "i", "i", "i", "i", "i", "i", "i", "i", "i", "i", "i", "i", "i", "i", "i", "i", "i", "i", "i", "i", "i", "i", "i", "i", "i", "i", "i", "i", "i", "i", "i", "i", "i", "i", "i", "i", "i", "i", "i", "i", "i", "i", "i", "i", "i", "i", "i", "i", "i", "i", "i", "i", "i", "i", "i", "i", "i", "i", "i", "i", "i", "i", "i", "i", "i", "i", "i", "i", "i", "i", "i", "i", "i", "i", "i", "i", "i", "i", "i", "i", "i", "i", "i", "i", "i", "i", "i", "i", "i", "i", "i", "i", "i", "i", "i", "i", "i", "i", "i", "i", "i", "i", "i", "i", "i", "i", "i", "i", "i", "i", "i", "i", "i", "i", "i", "i", "i", "i", "i", "i", "i", "i", "i", "i", "i", "i", "i", "i", "i", "i", "i", "i", "i", "i", "i", "i", "i", "i", "i", "i", "i", "i", "i", "i", "i", "i", "i", "i", "i", "i", "i", "i", "i", "i", "i", "i", "i", "i", "i", "i", "i", "i", "i", "i", "i", "i", "i", "i", "i", "i", "i", "i", "i", "i", "i", "i", "i", "i", "i", "i", "i", "i", "i", "i", "i", "i", "i", "i", "i", "i", "i", "i", "i", "i", "i", "i", "i", "i", "i", "i", "i", "i", "i", "i", "i", "i", "i", "i", "i", "i", "i", "i", "i", "i", "i", "i", "i", "i", "i", "i", "i", "i", "i", "i", "i", "i", "i", "i", "i", "i", "i", "i", "i", "i", "i", "i", "i", "i", "i", "i", "i", "i", "i", "i", "i", "i", "i", "i", "i", "i", "i", "i", "i", "i", "i", "i", "i", "i", "i", "i", "i", "i", "i", "i", "i", "i", "i", "i", "i", "i", "i", "i", "i", "i", "i", "i", "i", "i", "i", "i", "i", "i", "i", "i", "i", "i", "i", "i", "i", "i", "i", "i", "i", "i", "i", "i", "i", "i", "i", "i", "i", "i", "i", "i", "i", "i", "i", "i", "i", "i", "i", "i", "i", "i", "i", "i", "i", "i", "i", "i", "i", "i", "i", "i", "i", "i", "i", "i", "i", "i", "i", "i", "i", "i", "i", "i", "i", "i", "i", "i", "i", "i", "i", "i", "i", "i", "i", "i", "i", "i", "i", "i", "i", "i", "i", "i", "i", "i", "i", "i", "i", "i", "i", "i", "i", "i", "i", "i", "i", "i", "i", "i", "i", "i", "i", "i", "i", "i", "i", "i", "i", "i", "i", "i", "i", "i", "i", "i", "i", "i", "i", "i", "i", "i", "i", "i", "i", "i", "i", "i", "i", "i", "i", "i", "i", "i", "i", "i", "i", "i", "i", "i", "i", "i", "i", "i", "i", "i", "i", "i", "i", "i", "i", "i", "i", "i", "i", "i", "i", "i", "i", "i", "i", "i", "i", "i", "i", "i", "i", "i", "i", "i", "i", "i", "i", "i", "i", "i", "i", "i", "i", "i", "i", "i", "i", "i", "i", "i", "i", "i", "i", "i", "i", "i", "i", "i", "i", "i", "i", "i", "i", "i", "i", "i", "i", "i", "i", "i", "i", "i", "i", "i", "i", "i", "i", "i", "i", "i", "i", "i", "i", "i", "i", "i", "i", "i", "i", "i", "i", "i", "i", "i", "i", "i", "i", "i", "i", "i", "i", "i", "i", "i", "i", "i", "i", "i", "i", "i", "i", "i", "i", "i", "i", "i", "i", "i", "i", "i", "i", "i", "i", "i", "i", "i", "i", "i", "i", "i", "i", "i", "i", "i", "i", "i", "i", "i", "i", "i", "i", "i", "i", "i", "i", "i", "i", "i", "i", "i", "i", "i", "i", "i", "i", "i", "i", "i", "i", "i", "i", "i", "i", "i", "i", "i", "i", "i", "i", "i", "i", "i", "i", "i", "i", "i", "i", "i", "i", "i", "i", "i", "i", "i", "i", "i", "i", "i", "i", "i", "i", "i", "i", "i", "i", "i", "i", "i", "i", "i", "i", "i", "i", "i", "i", "i", "i", "i", "i", "i", "i", "i", "i", "i", "i", "i", "i", "i", "i", "i", "i", "i", "i", "i", "i", "i", "i", "i", "i", "i", "i", "i", "i", "i", "i", "i", "i", "i", "i", "i", "i", "i", "i", "i", "i", "i", "i", "i", "i", "i", "i", "i", "i", "i", "i", "i", "i", "i", "i", "i", "i", "i", "i", "i", "i", "i", "i", "i", "i", "i", "i", "i", "i", "i", "i", "i", "i", "i", "i", "i", "i", "i", "i", "i", "i", "i", "i", "i", "i", "i", "i", "i", "i", "i", "i", "i", "i", "i", "i", "i", "i", "i", "i", "i", "i", "i", "i", "i", "i", "i", "i", "i", "i", "i", "i", "i", "i", "i", "i", "i", "i", "i", "i", "i", "i", "i", "i", "i", "i", "i", "i", "i", "i", "i", "i", "i", "i", "i", "i", "i", "i", "i", "i", "i", "i", "i", "i", "i", "i", "i", "i", "i", "i", "i", "i", "i", "i", "i", "i", "i", "i", "i", "i", "i", "i", "i", "i", "i", "i", "i", "i", "i", "i", "i", "i", "i", "i", "i", "i", "i", "i", "i", "i", "i", "i", "i", "i", "i", "i", "i", "i", "i", "i", "i", "i", "i", "i", "i", "i", "i", "i", "i", "i", "i", "i", "i", "i", "i", "i", "i", "i", "i", "i", "i", "i", "i", "i", "i", "i", "i", "i", "i", "i", "i", "i", "i", "i", "i", "i", "i", "i", "i", "i", "i", "i", "i", "i", "i", "i", "i", "i", "i", "i", "i", "i", "i", "i", "i", "i", "i", "i", "i", "i", "i", "i", "i", "i", "i", "i", "i", "i", "i", "i", "i", "i", "i", "i", "i", "i", "i", "i", "i", "i", "i", "i", "i", "i", "i", "i", "i", "i", "i", "i", "i", "i", "i", "i", "i", "i", "i", "i", "i", "i", "i", "i", "i", "i", "i", "i", "i", "i", "i", "i", "i", "i", "i", "i", "i", "i", "i", "i", "i", "i", "i", "i", "i", "i", "i", "i", "i", "i", "i", "i", "i", "i", "i", "i", "i", "i", "i", "i", "i", "i", "i", "i", "i", "i", "i", "i", "i", "i", "i", "i", "i", "i", "i", "i", "i", "i", "i", "i", "i", "i", "i", "i", "i", "i", "i", "i", "i", "i", "i", "i", "i", "i", "i", "i", "i", "i", "i", "i", "i", "i", "i", "i", "i", "i", "i", "i", "i", "i", "i", "i", "i", "i", "i", "i", "i", "i", "i", "i", "i", "i", "i", "i", "i", "i", "i", "i", "i", "i", "i", "i", "i", "i", "i", "i", "i", "i", "i", "i", "i", "i", "i", "i", "i", "i", "i", "i", "i", "i", "i", "i", "i", "i", "i", "i", "i", "i", "i", "i", "i", "i", "i", "i", "i", "i", "i", "i", "i", "i", "i", "i", "i", "i", "i", "i", "i", "i", "i", "i", "i", "i", "i", "i", "i", "i", "i", "i", "i", "i", "i", "i", "i", "i", "i", "i", "i", "i", "i", "i", "i", "i", "i", "i", "i", "i", "i", "i", "i", "i", "i", "i", "i", "i", "i", "i", "i", "i", "i", "i", "i", "i", "i", "i", "i", "i", "i", "i", "i", "i", "i", "i", "i", "i", "i", "i", "i", "i", "i", "i", "i", "i", "i", "i", "i", "i", "i", "i", "i", "i", "i", "i", "i", "i", "i", "i", "i", "i", "i", "i", "i", "i", "i", "i", "i", "i", "i", "i", "i", "i", "i", "i", "i", "i", "i", "i", "i", "i", "i", "i", "i", "i", "i", "i", "i", "i", "i", "i", "i", "i", "i", "i", "i", "i", "i", "i", "i", "i", "i", "i", "i", "i", "i", "i", "i", "i", "i", "i", "i", "i", "i", "i", "i", "i", "i", "i", "i", "i", "i", "i", "i", "i", "i", "i", "i", "i", "i", "i", "i", "i", "i", "i", "i", "i", "i", "i", "i", "i", "i", "i", "i", "i", "i", "i", "i", "i", "i", "i", "i", "i", "i", "i", "i", "i", "i", "i", "i", "i", "i", "i", "i", "i", "i", "i", "i", "i", "i", "i", "i", "i", "i", "i", "i", "i", "i", "i", "i", "i", "i", "i", "i", "i", "i", "i", "i", "i", "i", "i", "i", "i", "i", "i", "i", "i", "i", "i", "i", "i", "i", "i", "i", "i", "i", "i", "i", "i", "i", "i", "i", "i", "i", "i", "i", "i", "i", "i", "i", "i", "i", "i", "i", "i", "i", "i", "i", "i", "i", "i", "i", "i", "i", "i", "i", "i", "i", "i", "i", "i", "i", "i", "i", "i", "i", "i", "i", "i", "i", "i", "i", "i", "i", "i", "i", "i", "i", "i", "i", "i", "i", "i", "i", "i", "i", "i", "i", "i", "i", "i", "i", "i", "i", "i", "i", "i", "i", "i", "i", "i", "i", "i", "i", "i", "i", "i", "i", "i", "i", "i", "i", "i", "i", "i", "i", "i", "i", "i", "i", "i", "i", "i", "i", "i", "i", "i", "i", "i", "i", "i", "i", "i", "i", "i", "i", "i", "i", "i", "i", "i", "i", "i", "i", "i", "i", "i", "i", "i", "i", "i", "i", "i", "i", "i", "i", "i", "i", "i", "i", "i", "i", "i", "i", "i", "i", "i", "i", "i", "i", "i", "i", "i", "i", "i", "i", "i", "i", "i", "i", "i", "i", "i", "i", "i", "i", "i", "i", "i", "i", "i", "i", "i", "i", "i", "i", "i", "i", "i", "i", "i", "i", "i", "i", "i", "i", "i", "i", "i", "i", "i", "i", "i", "i", "i", "i", "i", "i", "i", "i", "i", "i", "i", "i", "i", "i", "i", "i", "i", "i", "i", "i", "i", "i", "i", "i", "i", "i", "i", "i", "i", "i", "i", "i", "i", "i", "i", "i", "i", "i", "i", "i", "i", "i", "i", "i", "i", "i", "i", "i", "i", "i", "i", "i", "i", "i", "i", "i", "i", "i", "i", "i", "i", "i", "i", "i", "i", "i", "i", "i", "i", "i", "i", "i", "i", "i", "i", "i", "i", "i", "i", "i", "i", "i", "i", "i", "i", "i", "i", "i", "i", "i", "i", "i", "i", "i", "i", "i", "i", "i", "i", "i", "i", "i", "i", "i", "i", "i", "i", "i", "i", "i", "i", "i", "i", "i", "i", "i", "i", "i", "i", "i", "i", "i", "i", "i", "i", "i", "i", "i", "i", "i", "i", "i", "i", "i", "i", "i", "i", "i", "i", "i", "i", "i", "i", "i", "i", "i", "i", "i", "i", "i", "i", "i", "i", "i", "i", "i", "i", "i", "i", "i", "i", "i", "i", "i", "i", "i", "i", "i", "i", "i", "i", "i", "i", "i", "i", "i", "i", "i", "i", "i", "i", "i", "i", "i", "i", "i", "i", "i", "i", "i", "i", "i", "i", "i", "i", "i", "i", "i", "i", "i", "i", "i", "i", "i", "i", "i", "i", "i", "i", "i", "i", "i", "i", "i", "i", "i", "i", "i", "i", "i", "i", "i", "i", "i", "i", "i", "i", "i", "i", "i", "i", "i", "i", "i", "i", "i", "i", "i", "i", "i", "i", "i", "i", "i", "i", "i", "i", "i", "i", "i", "i", "i", "i", "i", "i", "i", "i", "i", "i", "i", "i", "i", "i", "i", "i", "i", "i", "i", "i", "i", "i", "i", "i", "i", "i", "i", "i", "i", "i", "i", "i", "i", "i", "i", "i", "i", "i", "i", "i", "i", "i", "i", "i", "i", "i", "i", "i", "i", "i", "i", "i", "i", "i", "i", "i", "i", "i", "i", "i", "i", "i", "i", "i", "i", "i", "i", "i", "i", "i", "i", "i", "i", "i", "i", "i", "i", "i", "i", "i", "i", "i", "i", "i", "i", "i", "i", "i", "i", "i", "i", "i", "i", "i", "i", "i", "i", "i", "i", "i", "i", "i", "i", "i", "i", "i", "i", "i", "i", "i", "i", "i", "i", "i", "i", "i", "i", "i", "i", "i", "i", "i", "i", "i", "i", "i", "i", "i", "i", "i", "i", "i", "i", "i", "i", "i", "i", "i", "i", "i", "i", "i", "i", "i", "i", "i", "i", "i", "i", "i", "i", "i", "i", "i", "i", "i", "i", "i", "i", "i", "i", "i", "i", "i", "i", "i", "i", "i", "i", "i", "i", "i", "i", "i", "i", "i", "i", "i", "i", "i", "i", "i", "i", "i", "i", "i", "i", "i", "i", "i", "i", "i", "i", "i", "i", "i", "i", "i", "i", "i", "i", "i", "i", "i", "i", "i", "i", "i", "i", "i", "i", "i", "i", "i", "i", "i", "i", "i", "i", "i", "i", "i", "i", "i", "i", "i", "i", "i", "i", "i", "i", "i", "i", "i", "i", "i", "i", "i", "i", "i", "i", "i", "i", "i", "i", "i", "i", "i", "i", "i", "i", "i", "i", "i", "i", "i", "i", "i", "i", "i", "i", "i", "i", "i", "i", "i", "i", "i", "i", "i", "i", "i", "i", "i", "i", "i", "i", "i", "i", "i", "i", "i", "i", "i", "i", "i", "i", "i", "i", "i", "i", "i", "i", "i", "i", "i", "i", "i", "i", "i", "i", "i", "i", "i", "i", "i", "i", "i", "i", "i", "i", "i", "i", "i", "i", "i", "i", "i", "i", "i", "i", "i", "i", "i", "i", "i", "i", "i", "i", "i", "i", "i", "i", "i", "i", "i", "i", "i", "i", "i", "i", "i", "i", "i", "i", "i", "i", "i", "i", "i", "i", "i", "i", "i", "i", "i", "i", "i", "i", "i", "i", "i", "i", "i", "i", "i", "i", "i", "i", "i", "i", "i", "i", "i", "i", "i", "i", "i", "i", "i", "i", "i", "i", "i", "i", "i", "i", "i", "i", "i", "i", "i", "i", "i", "i", "i", "i", "i", "i", "i", "i", "i", "i", "i", "i", "i", "i", "i", "i", "i", "i", "i", "i", "i", "i", "i", "i", "i", "i", "i", "i", "i", "i", "i", "i", "i", "i", "i", "i", "i", "i", "i", "i", "i", "i", "i", "i", "i", "i", "i", "i", "i", "i", "i", "i", "i", "i", "i", "i", "i", "i", "i", "i", "i", "i", "i", "i", "i", "i", "i", "i", "i", "i", "i", "i", "i", "i", "i", "i", "i", "i", "i", "i", "i", "i", "i", "i", "i", "i", "i", "i", "i", "i", "i", "i", "i", "i", "i", "i", "i", "i", "i", "i", "i", "i", "i", "i", "i", "i", "i", "i", "i", "i", "i", "i", "i", "i", "i", "i", "i", "i", "i", "i", "i", "i", "i", "i", "i", "i", "i", "i", "i", "i", "i", "i", "i", "i", "i", "i", "i", "i", "i", "i", "i", "i", "i", "i", "i", "i", "i", "i", "i", "i", "i", "i", "i", "i", "i", "i", "i", "i", "i", "i", "i", "i", "i", "i", "i", "i", "i", "i", "i", "i", "i", "i", "i", "i", "i", "i", "i", "i", "i", "i", "i", "i", "i", "i", "i", "i", "i", "i", "i", "i", "i", "i", "i", "i", "i", "i", "i", "i", "i", "i", "i", "i", "i", "i", "i", "i", "i", "i", "i", "i", "i", "i", "i", "i", "i", "i", "i", "i", "i", "i", "i", "i", "i", "i", "i", "i", "i", "i", "i", "i", "i", "i", "i", "i", "i", "i", "i", "i", "i", "i", "i", "i", "i", "i", "i", "i", "i", "i", "i", "i", "i", "i", "i", "i", "i", "i", "i", "i", "i", "i", "i", "i", "i", "i", "i", "i", "i", "i", "i", "i", "i", "i", "i", "i", "i", "i", "i", "i", "i", "i", "i", "i", "i", "i", "i", "i", "i", "i", "i", "i", "i", "i", "i", "i", "i", "i", "i", "i", "i", "i", "i", "i", "i", "i", "i", "i", "i", "i", "i", "i", "i", "i", "i", "i", "i", "i", "i", "i", "i", "i", "i", "i", "i", "i", "i", "i", "i", "i", "i", "i", "i", "i", "i", "i", "i", "i", "i", "i", "i", "i", "i", "i", "i", "i", "i", "i", "i", "i", "i", "i", "i", "i", "i", "i", "i", "i", "i", "i", "i", "i", "i", "i", "i", "i", "i", "i", "i", "i", "i", "i", "i", "i", "i", "i", "i", "i", "i", "i", "i", "i", "i", "i", "i", "i", "i", "i", "i", "i", "i", "i", "i", "i", "i", "i", "i", "i", "i", "i", "i", "i", "i", "i", "i", "i", "i", "i", "i", "i", "i", "i", "i", "i", "i", "i", "i", "i", "i", "i", "i", "i", "i", "i", "i", "i", "i", "i", "i", "i", "i", "i", "i", "i", "i", "i", "i", "i", "i", "i", "i", "i", "i", "i", "i", "i", "i", "i", "i", "i", "i", "i", "i", "i", "i", "i", "i", "i", "i", "i", "i", "i", "i", "i", "i", "i", "i", "i", "i", "i", "i", "i", "i", "i", "i", "i", "i", "i", "i", "i", "i", "i", "i", "i", "i", "i", "i", "i", "i", "i", "i", "i", "i", "i", "i", "i", "i", "i", "i", "i", "i", "i", "i", "i", "i", "i", "i", "i", "i", "i", "i", "i", "i", "i", "i", "i", "i", "i", "i", "i", "i", "i", "i", "i", "i", "i", "i", "i", "i", "i", "i", "i", "i", "i", "i", "i", "i", "i", "i", "i", "i", "i", "i", "i", "i", "i", "i", "i", "i", "i", "i", "i", "i", "i", "i", "i", "i", "i", "i", "i", "i", "i", "i", "i", "i", "i", "i", "i", "i", "i", "i", "i", "i", "i", "i", "i", "i", "i", "i", "i", "i", "i", "i", "i", "i", "i", "i", "i", "i", "i", "i", "i", "i", "i", "i", "i", "i", "i", "i", "i", "i", "i", "i", "i", "i", "i", "i", "i", "i", "i", "i", "i", "i", "i", "i", "i", "i", "i", "i", "i", "i", "i", "i", "i", "i", "i", "i", "i", "i", "i", "i", "i", "i", "i", "i", "i", "i", "i", "i", "i", "i", "i", "i", "i", "i", "i", "i", "i", "i", "i", "i", "i", "i", "i", "i", "i", "i", "i", "i", "i", "i", "i", "i", "i", "i", "i", "i", "i", "i", "i", "i", "i", "i", "i", "i", "i", "i", "i", "i", "i", "i", "i", "i", "i", "i", "i", "i", "i", "i", "i", "i", "i", "i", "i", "i", "i", "i", "i", "i", "i", "i", "i", "i", "i", "i", "i", "i", "i", "i", "i", "i", "i", "i", "i", "i", "i", "i", "i", "i", "i", "i", "i", "i", "i", "i", "i", "i", "i", "i", "i", "i", "i", "i", "i", "i", "i", "i", "i", "i", "i", "i", "i", "i", "i", "i", "i", "i", "i", "i", "i", "i", "i", "i", "i", "i", "i", "i", "i", "i", "i", "i", "i", "i", "i", "i", "i", "i", "i", "i", "i", "i", "i", "i", "i", "i", "i", "i", "i", "i", "i", "i", "i", "i", "i", "i", "i", "i", "i", "i", "i", "i", "i", "i", "i", "i", "i", "i", "i", "i", "i", "i", "i", "i", "i", "i", "i", "i", "i", "i", "i", "i", "i", "i", "i", "i", "i", "i", "i", "i", "i", "i", "i", "i", "i", "i", "i", "i", "i", "i", "i", "i", "i", "i", "i", "i", "i", "i", "i", "i", "i", "i", "i", "i", "i", "i", "i", "i", "i", "i", "i", "i", "i", "i", "i", "i", "i", "i", "i", "i", "i", "i", "i", "i", "i", "i", "i", "i", "i", "i", "i", "i", "i", "i", "i", "i", "i", "i", "i", "i", "i", "i", "i", "i", "i", "i", "i", "i", "i", "i", "i", "i", "i", "i", "i", "i", "i", "i", "i", "i", "i", "i", "i", "i", "i", "i", "i", "i", "i", "i", "i", "i", "i", "i", "i", "i", "i", "i", "i", "i", "i", "i", "i", "i", "i", "i", "i", "i", "i", "i", "i", "i", "i", "i", "i", "i", "i", "i", "i", "i", "i", "i", "i", "i", "i", "i", "i", "i", "i", "i", "i", "i", "i", "i", "i", "i", "i", "i", "i", "i", "i", "i", "i", "i", "i", "i", "i", "i", "i", "i", "i", "i", "i", "i", "i", "i", "i", "i", "i", "i", "i", "i", "i", "i", "i", "i", "i", "i", "i", "i", "i", "i", "i", "i", "i", "i", "i", "i", "i", "i", "i", "i", "i", "i", "i", "i", "i", "i", "i", "i", "i", "i", "i", "i", "i", "i", "i", "i", "i", "i", "i", "i", "i", "i", "i", "i", "i", "i", "i", "i", "i", "i", "i", "i", "i", "i", "i", "i", "i", "i", "i", "i", "i", "i", "i", "i", "i", "i", "i", "i", "i", "i", "i", "i", "i", "i", "i", "i", "i", "i", "i", "i", "i", "i", "i", "i", "i", "i", "i", "i", "i", "i", "i", "i", "i", "i", "i", "i", "i", "i", "i", "i", "i", "i", "i", "i", "i"]	[]	TODO
"vnvnvnvnvnvnvnvnvnvnvnvnvnvnvnvnvnvnvnvnvnvnvnvnvnvnvnvnvnvnvnvnvnvnvnvnvnvnvnvnvnvnvnvnvnvnvnvnvnvnvnvnvnvnvnvnvnvnvnvnvnvnvnvnvnvnvnvnvnvnvnvnvnvnvnvnvnvnvnvnvnvnvnvnvnvnvnvnvnvnvnvnvnvnvnvnvnvnvnvnvnvnvnvnvnvnvnvnvnvnvnvnvnvnvnvnvnvnvnvnvnvnvnvnvnvnvnvnvnvnvnvnvnvnvnvnvnvnvnvnvnvnvnvnvnvnvnvnvnvnvnvnvnvnvnvnvnvnvnvnvnvnvnvnvnvnvnvnvnvnvnvnvnvnvnvnvnvnvnvnvnvnvnvnvnvnvnvnvnvnvnvnvnvnvnvnvnvnvnvnvnvnvnvnvnvnvnvnvnvnvnvnvnvnvnvnvnvnvnvnvnvnvnvnvnvnvnvnvnvnvnvnvnvnvnvnvnvnvnvnvnvnvnvnvnvnvnvnvnvnvnvnvnvnvnvnvnvnvnvnvnvnvnvnvnvnvnvnvnvnvnvnvnvnvnvnvnvnvnvnvnvnvnvnvnvnvnvnvnvnvnvnvnvnvnvnvnvnvnvnvnvnvnvnvnvnvnvnvnvnvnvnvnvnvnvnvnvnvnvnvnvnvnvnvnvnvnvnvnvnvnvnvnvnvnvnvnvnvnvnvnvnvnvnvnvnvnvnvnvnvnvnvnvnvnvnvnvnvnvnvnvnvnvnvnvnvnvnvnvnvnvnvnvnvnvnvnvnvnvnvnvnvnvnvnvnvnvnvnvnvnvnvnvnvnvnvnvnvnvnvnvnvnvnvnvnvnvnvnvnvnvnvnvnvnvnvnvnvnvnvnvnvnvnvnvnvnvnvnvnvnvnvnvnvnvnvnvnvnvnvnvnvnvnvnvnvnvnvnvnvnvnvnvnvnvnvnvnvnvnvnvnvnvnvnvnvnvnvnvnvnvnvnvnvnvnvnvnvnvnvnvnvnvnvnvnvnvnvnvnvnvnvnvnvnvnvnvnvnvnvnvnvnvnvnvnvnvnvnvnvnvnvnvnvnvnvnvnvnvnvnvnvnvnvnvnvnvnvnvnvnvnvnvnvnvnvnvnvnvnvnvnvnvnvnvnvnvnvnvnvnvnvnvnvnvnvnvnvnvnvnvnvnvnvnvnvnvnvnvnvnvnvnvnvnvnvnvnvnvnvnvnvnvnvnvnvnvnvnvnvnvnvnvnvnvnvnvnvnvnvnvnvnvnvnvnvnvnvnvnvnvnvnvnvnvnvnvnvnvnvnvnvnvnvnvnvnvnvnvnvnvnvnvnvnvnvnvnvnvnvnvnvnvnvnvnvnvnvnvnvnvnvnvnvnvnvnvnvnvnvnvnvnvnvnvnvnvnvnvnvnvnvnvnvnvnvnvnvnvnvnvnvnvnvnvnvnvnvnvnvnvnvnvnvnvnvnvnvnvnvnvnvnvnvnvnvnvnvnvnvnvnvnvnvnvnvnvnvnvnvnvnvnvnvnvnvnvnvnvnvnvnvnvnvnvnvnvnvnvnvnvnvnvnvnvnvnvnvnvnvnvnvnvnvnvnvnvnvnvnvnvnvnvnvnvnvnvnvnvnvnvnvnvnvnvnvnvnvnvnvnvnvnvnvnvnvnvnvnvnvnvnvnvnvnvnvnvnvnvnvnvnvnvnvnvnvnvnvnvnvnvnvnvnvnvnvnvnvnvnvnvnvnvnvnvnvnvnvnvnvnvnvnvnvnvnvnvnvnvnvnvnvnvnvnvnvnvnvnvnvnvnvnvnvnvnvnvnvnvnvnvnvnvnvnvnvnvnvnvnvnvnvnvnvnvnvnvnvnvnvnvnvnvnvnvnvnvnvnvnvnvnvnvnvnvnvnvnvnvnvnvnvnvnvnvnvnvnvnvnvnvnvnvnvnvnvnvnvnvnvnvnvnvnvnvnvnvnvnvnvnvnvnvnvnvnvnvnvnvnvnvnvnvnvnvnvnvnvnvnvnvnvnvnvnvnvnvnvnvnvnvnvnvnvnvnvnvnvnvnvnvnvnvnvnvnvnvnvnvnvnvnvnvnvnvnvnvnvnvnvnvnvnvnvnvnvnvnvnvnvnvnvnvnvnvnvnvnvnvnvnvnvnvnvnvnvnvnvnvnvnvnvnvnvnvnvnvnvnvnvnvnvnvnvnvnvnvnvnvnvnvnvnvnvnvnvnvnvnvnvnvnvnvnvnvnvnvnvnvnvnvnvnvnvnvnvnvnvnvnvnvnvnvnvnvnvnvnvnvnvnvnvnvnvnvnvnvnvnvnvnvnvnvnvnvnvnvnvnvnvnvnvnvnvnvnvnvnvnvnvnvnvnvnvnvnvnvnvnvnvnvnvnvnvnvnvnvnvnvnvnvnvnvnvnvnvnvnvnvnvnvnvnvnvnvnvnvnvnvnvnvnvnvnvnvnvnvnvnvnvnvnvnvnvnvnvnvnvnvnvnvnvnvnvnvnvnvnvnvnvnvnvnvnvnvnvnvnvnvnvnvnvnvnvnvnvnvnvnvnvnvnvnvnvnvnvnvnvnvnvnvnvnvnvnvnvnvnvnvnvnvnvnvnvnvnvnvnvnvnvnvnvnvnvnvnvnvnvnvnvnvnvnvnvnvnvnvnvnvnvnvnvnvnvnvnvnvnvnvnvnvnvnvnvnvnvnvnvnvnvnvnvnvnvnvnvnvnvnvnvnvnvnvnvnvnvnvnvnvnvnvnvnvnvnvnvnvnvnvnvnvnvnvnvnvnvnvnvnvnvnvnvnvnvnvnvnvnvnvnvnvnvnvnvnvnvnvnvnvnvnvnvnvnvnvnvnvnvnvnvnvnvnvnvnvnvnvnvnvnvnvnvnvnvnvnvnvnvnvnvnvnvnvnvnvnvnvnvnvnvnvnvnvnvnvnvnvnvnvnvnvnvnvnvnvnvnvnvnvnvnvnvnvnvnvnvnvnvnvnvnvnvnvnvnvnvnvnvnvnvnvnvnvnvnvnvnvnvnvnvnvnvnvnvnvnvnvnvnvnvnvnvnvnvnvnvnvnvnvnvnvnvnvnvnvnvnvnvnvnvnvnvnvnvnvnvnvnvnvnvnvnvnvnvnvnvnvnvnvnvnvnvnvnvnvnvnvnvnvnvnvnvnvnvnvnvnvnvnvnvnvnvnvnvnvnvnvnvnvnvnvnvnvnvnvnvnvnvnvnvnvnvnvnvnvnvnvnvnvnvnvnvnvnvnvnvnvnvnvnvnvnvnvnvnvnvnvnvnvnvnvnvnvnvnvnvnvnvnvnvnvnvnvnvnvnvnvnvnvnvnvnvnvnvnvnvnvnvnvnvnvnvnvnvnvnvnvnvnvnvnvnvnvnvnvnvnvnvnvnvnvnvnvnvnvnvnvnvnvnvnvnvnvnvnvnvnvnvnvnvnvnvnvnvnvnvnvnvnvnvnvnvnvnvnvnvnvnvnvnvnvnvnvnvnvnvnvnvnvnvnvnvnvnvnvnvnvnvnvnvnvnvnvnvnvnvnvnvnvnvnvnvnvnvnvnvnvnvnvnvnvnvnvnvnvnvnvnvnvnvnvnvnvnvnvnvnvnvnvnvnvnvnvnvnvnvnvnvnvnvnvnvnvnvnvnvnvnvnvnvnvnvnvnvnvnvnvnvnvnvnvnvnvnvnvnvnvnvnvnvnvnvnvnvnvnvnvnvnvnvnvnvnvnvnvnvnvnvnvnvnvnvnvnvnvnvnvnvnvnvnvnvnvnvnvnvnvnvnvnvnvnvnvnvnvnvnvnvnvnvnvnvnvnvnvnvnvnvnvnvnvnvnvnvnvnvnvnvnvnvnvnvnvnvnvnvnvnvnvnvnvnvnvnvnvnvnvnvnvnvnvnvnvnvnvnvnvnvnvnvnvnvnvnvnvnvnvnvnvnvnvnvnvnvnvnvnvnvnvnvnvnvnvnvnvnvnvnvnvnvnvnvnvnvnvnvnvnvnvnvnvnvnvnvnvnvnvnvnvnvnvnvnvnvnvnvnvnvnvnvnvnvnvnvnvnvnvnvnvnvnvnvnvnvnvnvnvnvnvnvnvnvnvnvnvnvnvnvnvnvnvnvnvnvnvnvnvnvnvnvnvnvnvnvnvnvnvnvnvnvnvnvnvnvnvnvnvnvnvnvnvnvnvnvnvnvnvnvnvnvnvnvnvnvnvnvnvnvnvnvnvnvnvnvnvnvnvnvnvnvnvnvnvnvnvnvnvnvnvnvnvnvnvnvnvnvnvnvnvnvnvnvnvnvnvnvnvnvnvnvnvnvnvnvnvnvnvnvnvnvnvnvnvnvnvnvnvnvnvnvnvnvnvnvnvnvnvnvnvnvnvnvnvnvnvnvnvnvnvnvnvnvnvnvnvnvnvnvnvnvnvnvnvnvnvnvnvnvnvnvnvnvnvnvnvnvnvnvnvnvnvnvnvnvnvnvnvnvnvnvnvnvnvnvnvnvnvnvnvnvnvnvnvnvnvnvnvnvnvnvnvnvnvnvnvnvnvnvnvnvnvnvnvnvnvnvnvnvnvnvnvnvnvnvnvnvnvnvnvnvnvnvnvnvnvnvnvnvnvnvnvnvnvnvnvnvnvnvnvnvnvnvnvnvnvnvnvnvnvnvnvnvnvnvnvnvnvnvnvnvnvnvnvnvnvnvnvnvnvnvnvnvnvnvnvnvnvnvnvnvnvnvnvnvnvnvnvnvnvnvnvnvnvnvnvnvnvnvnvnvnvnvnvnvnvnvnvnvnvnvnvnvnvnvnvnvnvnvnvnvnvnvnvnvnvnvnvnvnvnvnvnvnvnvnvnvnvnvnvnvnvnvnvnvnvnvnvnvnvnvnvnvnvnvnvnvnvnvnvnvnvnvnvnvnvnvnvnvnvnvnvnvnvnvnvnvnvnvnvnvnvnvnvnvnvnvnvnvnvnvnvnvnvnvnvnvnvnvnvnvnvnvnvnvnvnvnvnvnvnvnvnvnvnvnvnvnvnvnvnvnvnvnvnvnvnvnvnvnvnvnvnvnvnvnvnvnvnvnvnvnvnvnvnvnvnvnvnvnvnvnvnvnvnvnvnvnvnvnvnvnvnvnvnvnvnvnvnvnvnvnvnvnvnvnvnvnvnvnvnvnvnvnvnvnvnvnvnvnvnvnvnvnvnvnvnvnvnvnvnvnvnvnvnvnvnvnvnvnvnvnvnvnvnvnvnvnvnvnvnvnvnvnvnvnvnvnvnvnvnvnvnvnvnvnvnvnvnvnvnvnvnvnvnvnvnvnvnvnvnvnvnvnvnvnvnvnvnvnvnvnvnvnvnvnvnvnvnvnvnvnvnvnvnvnvnvnvnvnvnvnvnvnvnvnvnvnvnvnvnvnvnvnvnvnvnvnvnvnvnvnvnvnvnvnvnvnvnvnvnvnvnvnvnvnvnvnvnvnvnvnvnvnvnvnvnvnvnvnvnvnvnvnvnvnvnvnvnvnvnvnvnvnvnvnvnvnvnvnvnvnvnvnvnvnvnvnvnvnvnvnvnvnvnvnvnvnvnvnvnvnvnvnvnvnvnvnvnvnvnvnvnvnvnvnvnvnvnvnvnvnvnvnvnvnvnvnvnvnvnvnvnvnvnvnvnvnvnvnvnvnvnvnvnvnvnvnvnvnvnvnvnvnvnvnvnvnvnvnvnvnvnvnvnvnvnvnvnvnvnvnvnvnvnvnvnvnvnvnvnvnvnvnvnvnvnvnvnvnvnvnvnvnvnvnvnvnvnvnvnvnvnvnvnvnvnvnvnvnvnvnvnvnvnvnvnvnvnvnvnvnvnvnvnvnvnvnvnvnvnvnvnvnvnvnvnvnvnvnvnvnvnvnvnvnvnvnvnvnvnvnvnvnvnvnvnvnvnvnvnvnvnvnvnvnvnvnvnvnvnvnvnvnvnvnvnvnvnvnvnvnvnvnvnvnvnvnvnvnvnvnvnvnvnvnvnvnvnvnvnvnvnvnvnvnvnvnvnvnvnvnvnvnvnvnvnvnvnvnvnvnvnvnvnvnvnvnvnvnvnvnvnvnvnvnvnvnvnvnvnvnvnvnvnvnvnvnvnvnvnvnvnvnvnvnvnvnvnvnvnvnvnvnvnvnvnvnvnvnvnvnvnvnvnvnvnvnvnvnvnvnvnvnvnvnvnvnvnvnvnvnvnvnvnvnvnvnvnvnvnvnvnvnvnvnvnvnvnvnvnvnvnvnvnvnvnvnvnvnvnvnvnvnvnvnvnvnvnvnvnvnvnvnvnvnvnvnvnvnvnvnvnvnvnvnvnvnvnvnvnvnvnvnvnvnvnvnvnvnvnvnvnvnvnvnvnvnvnvnvnvnvnvnvnvnvnvnvnvnvnvnvnvnvnvnvnvnvnvnvnvnvnvnvnvnvnvnvnvnvnvnvnvnvnvnvnvnvnvnvnvnvnvnvnvnvnvnvnvnvnvnvnvnvnvnvnvnvnvnvnvnvnvnvnvnvnvnvnvnvnvnvnvnvnvnvnvnvnvnvnvnvnvnvnvnvnvnvnvnvnvnvnvnvnvnvnvnvnvnvnvnvnvnvnvnvnvnvnvnvnvnvnvnvnvnvnvnvnvnvnvnvnvnvnvnvnvnvnvnvnvnvnvnvnvnvnvnvnvnvnvnvnvnvnvnvnvnvnvnvnvnvnvnvnvnvnvnvnvnvnvnvnvnvnvnvnvnvnvnvnvnvnvnvnvnvnvnvnvnvnvnvnvnvnvnvnvnvnvnvnvnvnvnvnvnvnvnvnvnvnvnvnvnvnvnvnvnvnvnvnvnvnvnvnvnvnvnvnvnvnvnvnvnvnvnvnvnvnvnvnvnvnvnvnvnvnvnvnvnvnvnvnvnvnvnvnvnvnvnvnvnvnvnvnvnvnvnvnvnvnvnvnvnvnvnvnvnvnvnvnvnvnvnvnvnvnvnvnvnvnvnvnvnvnvnvnvnvnvnvnvnvnvnvnvnvnvnvnvnvnvnvnvnvnvnvnvnvnvnvnvnvnvnvnvnvnvnvnvnvnvnvnvnvnvnvnvnvnvnvnvnvnvnvnvnvnvnvnvnvnvnvnvnvnvnvnvnvnvnvnvnvnvnvnvnvnvnvnvnvnvnvnvnvnvnvnvnvnvnvnvnvnvnvnvnvnvnvnvnvnvnvnvnvnvnvnvnvnvnvnvnvnvnvnvnvnvnvnvnvnvnvnvnvnvnvnvnvnvnvnvnvnvnvnvnvnvnvnvnvnvnvnvnvnvnvnvnvnvnvnvnvnvnvnvnvnvnvnvnvnvnvnvnvnvnvnvnvnvnvnvnvnvnvnvnvnvnvnvnvnvnvnvnvnvnvnvnvnvnvnvnvnvnvnvnvnvnvnvnvnvnvnvnvnvnvnvnvnvnvnvnvnvnvnvnvnvnvnvnvnvnvnvnvnvnvnvnvnvnvnvnvnvnvnvnvnvnvnvnvnvnvnvnvnvnvnvnvnvnvnvnvnvnvnvnvnvnvnvnvnvnvnvnvnvnvnvnvnvnvnvnvnvnvnvnvnvnvnvnvnvnvnvnvnvnvnvnvnvnvnvnvnvnvnvnvnvnvnvnvnvnvnvnvnvnvnvnvnvnvnvnvnvnvnvnvnvnvnvnvnvnvnvnvnvnvnvnvnvnvnvnvnvnvnvnvnvnvnvnvnvnvnvnvnvnvnvnvnvnvnvnvnvnvnvnvnvnvnvnvnvnvnvnvnvnvnvnvnvnvnvnvnvnvnvnvnvnvnvnvnvnvnvnvnvnvnvnvnvnvnvnvnvnvnvnvnvnvnvnvnvnvnvnvnvnvnvnvnvnvnvnvnvnvnvnvnvnvnvnvnvnvnvnvnvnvnvnvnvnvnvnvnvnvnvnvnvnvnvnvnvnvnvnvnvnvnvnvnvnvnvnvnvnvnvnvnvnvnvnvnvnvnvnvnvnvnvnvnvnvnvnvnvnvnvnvnvnvnvnvnvnvnvnvnvnvnvnvnvnvnvnvnvnvnvnvnvnvnvnvnvnvnvnvnvnvnvnvnvnvnvnvnvnvnvnvnvnvnvnvnvnvnvnvnvnvnvnvnvnvnvnvnvnvnvnvnvnvnvnvnvnvnvnvnvnvnvnvnvnvnvnvnvnvnvnvnvnvnvnvnvnvnvnvnvnvnvnvnvnvnvnvnvnvnvnvnvnvnvnvnvnvnvnvnvnvnvnvnvnvnvnvnvnvnvnvnvnvnvnvnvnvnvnvnvnvnvnvnvnvnvnvnvnvnvnvnvnvnvnvnvnvnvnvnvnvnvnvnvnvnvnvnvnvnvnvnvnvnvnvnvnvnvnvnvnvnvnvnvnvnvnvnvnvnvnvnvnvnvnvnvnvnvnvnvnvnvnvnvnvnvnvnvnvnvnvnvnvnvnvnvnvnvnvnvnvnvnvnvnvnvnvnvnvnvnvnvnvnvnvnvnvnvnvnvnvnvnvnvnvnvnvnvnvnvnvnvnvnvnvnvnvnvnvnvnvnvnvnvnvnvnvnvnvnvnvnvnvnvnvnvnvnvnvnvnvnvnvnvnvnvnvnvnvnvnvnvnvnvnvnvnvnvnvnvnvnvnvnvnvnvnvnvnvnvnvnvnvnvnvnvnvnvnvnvnvnvnvnvnvnvnvnvnvnvnvnvnvnvnvnvnvnvnvnvnvnvnvnvnvnvnvnvnvnvnvnvnvnvnvnvnvnvnvnvnvnvnvnvnvnvnvnvnvnvnvnvnvnvnvnvnvnvnvnvnvnvnvnvnvnvnvnvnvnvnvnvnvnvnvnvnvnvnvnvnvnvnvnvnvnvnvnvnvnvnvnvnvnvnvnvnvnvnvnvnvnvnvnvnvnvnvnvnvnvnvnvnvnvnvnvnvnvnvnvnvnvnvnvnvnvnvnvnvnvnvnvnvnvnvnvnvnvnvnvnvnvnvnvnvnvnvnvnvnvnvnvnvnvnvnvnvnvnvnvnvnvnvnvnvnvnvnvnvnvnvnvnvnvnvnvnvnvnvnvnvnvnvnvnvnvnvnvnvnvnvnvnvnvnvnvnvnvnvnvnvnvnvnvnvnvnvnvnvnvnvnvnvnvnvnvnvnvnvnvnvnvnvnvnvnvnvnvnvnvnvnvnvnvnvnvnvnvnvnvnvnvnvnvnvnvnvnvnvnvnvnvnvnvnvnvnvnvnvnvnvnvnvnvnvnvnvnvnvnvnvnvnvnvnvnvnvnvnvnvnvnvnvnvnvnvnvnvnvnvnvnvnvnvnvnvnvnvnvnvnvnvnvnvnvnvnvnvnvnvnvnvnvnvnvnvnvnvnvnvnvnvnvnvnvnvnvnvnvnvnvnvnvnvnvnvnvnvnvnvnvnvnvnvnvnvnvnvnvnvnvnvnvnvnvnvnvnvnvnvnvnvnvnvnvnvnvnvnvnvnvnvnvnvnvnvnvnvnvnvnvnvnvnvnvnvnvnvnvnvnvnvnvnvnvnvnvnvnvnvnvnvnvnvnvnvnvnvnvnvnvnvnvnvnvnvnvnvnvnvnvnvnvnvnvnvnvnvnvnvnvnvnvnvnvnvnvnvnvnvnvnvnvnvnvnvnvnvnvnvnvnvnvnvnvnvnvnvnvnvnvnvnvnvnvnvnvnvnvnvnvnvnvnvnvnvnvnvnvnvnvnvnvnvnvnvnvnvnvnvnvnvnvnvnvnvnvnvnvnvnvnvnvnvnvnvnvnvnvnvnvnvnvnvnvnvnvnvnvnvnvnvnvnvnvnvnvnvnvnvnvnvnvnvnvnvnvnvnvnvnvnvnvnvnvnvnvnvnvnvnvnvnvnvnvnvnvnvnvnvnvnvnvnvnvnvnvnvnvnvnvnvnvnvnvnvnvnvnvnvnvnvnvnvnvnvnvnvnvnvnvnvnvnvnvnvnvnvnvnvnvnvnvnvnvnvnvnvnvnvnvnvnvnvnvnvnvnvnvnvnvnvnvnvnvnvnvnvnvnvnvnvnvnvnvnvnvnvnvnvnvnvnvnvnvnvnvnvnvnvnvnvnvnvnvnvnvnvnvnvnvnvnvnvnvnvnvnvnvnvnvnvnvnvnvnvnvnvnvnvnvnvnvnvnvnvnvnvnvnvnvnvnvnvnvnvnvnvnvnvnvnvnvnvnvnvnvnvnvnvnvnvnvnvnvnvnvnvnvnvnvnvnvnvnvnvnvnvnvnvnvnvnvnvnvnvnvnvnvnvnvnvnvnvnvnvnvnvnvnvnvnvnvnvnvnvnvnvnvnvnvnvnvnvnvnvnvnvnvnvnvnvnvnvnvnvnvnvnvnvnvnvnvnvnvnvnvnvnvnvnvnvnvnvnvnvnvnvnvnvnvnvnvnvnvnvnvnvnvnvnvnvnvnvnvnvnvnvnvnvnvnvnvnvnvnvnvnvnvnvnvnvnvnvnvnvnvnvnvnvnvnvnvnvnvnvnvnvnvnvnvnvnvnvnvnvnvnvnvnvnvnvnvnvnvnvnvnvnvnvnvnvnvnvnvnvnvnvnvnvnvnvnvnvnvnvnvnvnvnvnvnvnvnvnvnvnvnvnvnvnvnvnvnvnvnvnvnvnvnvnvnvnvnvnvnvnvnvnvnvnvnvnvnvnvnvnvnvnvnvnvnvnvnvnvnvnvnvnvnvnvnvnvnvnvnvnvnvnvnvnvnvnvnvnvnvnvnvnvnvnvnvnvnvnvnvnvnvnvnvnvnvnvnvnvn"	["vn", "nv", "vn", "nv", "vn", "nv", "vn", "nv", "vn", "nv", "vn", "nv", "vn", "nv", "vn", "nv", "vn", "nv", "vn", "nv", "vn", "nv", "vn", "nv", "vn", "nv", "vn", "nv", "vn", "nv", "vn", "nv", "vn", "nv", "vn", "nv", "vn", "nv", "vn", "nv", "vn", "nv", "vn", "nv", "vn", "nv", "vn", "nv", "vn", "nv", "vn", "nv", "vn", "nv", "vn", "nv", "vn", "nv", "vn", "nv", "vn", "nv", "vn", "nv", "vn", "nv", "vn", "nv", "vn", "nv", "vn", "nv", "vn", "nv", "vn", "nv", "vn", "nv", "vn", "nv", "vn", "nv", "vn", "nv", "vn", "nv", "vn", "nv", "vn", "nv", "vn", "nv", "vn", "nv", "vn", "nv", "vn", "nv", "vn", "nv", "vn", "nv", "vn", "nv", "vn", "nv", "vn", "nv", "vn", "nv", "vn", "nv", "vn", "nv", "vn", "nv", "vn", "nv", "vn", "nv", "vn", "nv", "vn", "nv", "vn", "nv", "vn", "nv", "vn", "nv", "vn", "nv", "vn", "nv", "vn", "nv", "vn", "nv", "vn", "nv", "vn", "nv", "vn", "nv", "vn", "nv", "vn", "nv", "vn", "nv", "vn", "nv", "vn", "nv", "vn", "nv", "vn", "nv", "vn", "nv", "vn", "nv", "vn", "nv", "vn", "nv", "vn", "nv", "vn", "nv", "vn", "nv", "vn", "nv", "vn", "nv", "vn", "nv", "vn", "nv", "vn", "nv", "vn", "nv", "vn", "nv", "vn", "nv", "vn", "nv", "vn", "nv", "vn", "nv", "vn", "nv", "vn", "nv", "vn", "nv"]	[]	TODO
